Informhead
An Interactive Fiction by Ed Peters
Release 1 / Serial number 230628 / Inform 7 v10.1.2 / D

Outside the Real Estate Office
A grim little cul-de-sac, tucked away in a corner of the claustrophobic tangle of narrow, twisting avenues that largely constitute the older portion of Anchorhead. Like most of the streets in this city, it is ancient, shadowy, and leads essentially nowhere. The lane ends here at the real estate agent's office, which lies to the east, and winds its way back toward the center of town to the west. A narrow, garbage-choked alley opens to the southeast.

>day4
Padded Cell
You are in a padded cell, the kind typically reserved for raving lunatics. The room is barely eight feet by eight feet square, with walls and floor of concrete covered with thick, quilted padding. The door in the west wall is also covered with padding, except for a tiny observation window about five feet up, from which a feeble light trickles in.

* * *

>close hole 1
You slide a finger to cover the the first hole.

"It would almost be too kind to kill you," muses the ghost. "I've half a mind to simply let you go, and spend the next four hundred years tormenting and violating your future daughters and grand-daughters through the next twelve generations. You've only got one amulet, you know; you can't protect all your children at once.".

>blow flute
Home
You are home, and it is a momentous event. Downstairs, Michael is waiting for you to bring him the wondrous news. To the east is the bedroom you both share, and to the north is your bathroom.

A cool wave of uneasiness washes slowly over you; you're not sure why..

[Your score has just gone up by fifteen points.]

* * *

>close hole 1
You slide a finger to cover the the first hole.

"It would almost be too kind to kill you," muses the ghost. "I've half a mind to simply let you go, and spend the next four hundred years tormenting and violating your future daughters and grand-daughters through the next twelve generations. You've only got one amulet, you know; you can't protect all your children at once.".

>close hole 5
You slide a finger to cover the the fifth hole.

"It would almost be too kind to kill you," muses the ghost. "I've half a mind to simply let you go, and spend the next four hundred years tormenting and violating your future daughters and grand-daughters through the next twelve generations. You've only got one amulet, you know; you can't protect all your children at once.".

>blow flute
Home
You are home, and it is a momentous event. Downstairs, Michael is waiting for you to bring him the wondrous news. To the east is the bedroom you both share, and to the north is your bathroom.

A cool wave of uneasiness washes slowly over you; you're not sure why..

[Your score has just gone up by fifteen points.]

>l
Home
You are home, and it is a momentous event. Downstairs, Michael is waiting for you to bring him the wondrous news. To the east is the bedroom you both share, and to the north is your bathroom.

"Well?" Michael calls excitedly from downstairs. "Have you looked yet?".

>full score
92: Banish the ghost of Croesus Verlac (15).
87: Giving the amulet to Michael (5).
86: Showing Michael your wedding ring (5).
54: Killing William Verlac (2).
38: Freeing the madman (2).
13: Reading Edward's jailhouse letter (2).
4: Escaping the strait jacket (2).

>n
Bathroom
Your bathroom; an ordinary place. A normal, safe, familiar place.

On the counter is a home pregnancy test.

Michael calls up again, this time sounding slightly worried: "Hon? Everything okay up there?".

>x test
It's an ordinary pregnancy test, the kind you can get at any drugstore; the kind with the little window that turns pink if you're going to have a baby.

A nameless, formless apprehension grips you suddenly, leaving you short of breath. Why are you so frightened, on what should be such a joyous occasion?.

>x window
(the pregnancy result)
The window is pink. The test is positive.

From downstairs, you can hear Michael joyfully talking to himself:

"Oh, I hope it's a little girl," he says. "I've always wanted to have a little girl."

    *** You have won ... for now ***

In that game you scored 33 out of a possible 0, in 96 turns.

Would you like to RESTART, RESTORE a saved game, QUIT or UNDO the last command?

* * *

>close hole 1
You slide a finger to cover the the first hole.

"It would almost be too kind to kill you," muses the ghost. "I've half a mind to simply let you go, and spend the next four hundred years tormenting and violating your future daughters and grand-daughters through the next twelve generations. You've only got one amulet, you know; you can't protect all your children at once.".

>take flute. close hole 1. close hole 5.
(putting the keyring into the trench coat to make room)
You slip the keyring into the pocket of your trench coat.

Taken.

"You sabotaged my dimensional beacon -- I will build another. You drove me from my host body -- I will find another. What next? Will you track down my disciples, one by one, and kill them all? Will you set this whole town to the torch?".

You slide a finger to cover the the first hole.

"There will be more towns, woman, and more bodies, and more disciples, and always will I be there. And there is NOTHING YOU CAN DO TO STOP ME!".

You slide a finger to cover the the fifth hole.

"It would almost be too kind to kill you," muses the ghost. "I've half a mind to simply let you go, and spend the next four hundred years tormenting and violating your future daughters and grand-daughters through the next twelve generations. You've only got one amulet, you know; you can't protect all your children at once.".

>blow flute
FLUTE SOUND = s.
CLOSED HOLES = first hole and fifth hole.
FLUTE EFFECT = 2.
The strange harmony of the flute blends with the atonal ringing of the two columns, and the three sounds suddenly grow stronger, resonating with and reinforcing one another, intertwining like a dissonant, invisible braid. The sound increases in volume, piercing your eardrums and causing the very air to shimmer.

Suddenly the air above the altar begins to ripple as though with extreme heat. The very fabric of space seems to twist and buckle between the two columns; and then, with a sound like a wet sheet being torn slowly down the middle, the fabric splits.

You are immediately swept off your feet by a powerful sucking vacuum, pulling everything within reach toward the portal. Dust and debris; bones and loose rock from the burial niches; everything not nailed down goes flying across the temple and into the all-devouring maw hovering over the altar-stone. Desperately, you wedge your fingers into a crack in the floor; with the other hand you grasp hold of Michael's pants leg and hang on for dear life.

Verlac is caught like a gossamer thread in a tornado. Frantically he claws at the air, but as an insubstantial ghost there is nothing for him to hang on to. Shrieking and cursing, he is dragged inexorably back, closer and closer to the portal, until the suction draws his corpus out into a long, trailing ribbon, like an unraveling cable-knit sweater -- and in the next moment he is gone forever, sucked into whatever alien dimension lies beyond that horrible rift.

Painstakingly, you pry your stiff, bleeding fingers out of the crack and roll over. The rift is gone. The air is normal, and the columns are ringing quietly, as if nothing had happened.

>scenes
Scene 'Entire Game' playing (for 92 mins now)
Scene 'Day 1' playing (for 92 mins now)
Scene 'Day 4' playing (for 92 mins now)
Scene 'Loony Binned' ended
Scene 'Mob Justice' ended
Scene 'Will Attacks' ended
Scene 'Michael Inspects' ended
Scene 'Michael Demands' ended
Scene 'Michael Summons' ended
Scene 'Abandon Ship' ended
Scene 'Michael Flees' ended
Scene 'Michael Coughs' ended
(Scene monitoring now switched on. Type "scenes off" to switch it off again.)

* * *

>take flute. close hole 1. close hole 5.
(putting the keyring into the trench coat to make room)
You slip the keyring into the pocket of your trench coat.

Taken.

The ghost lets out a chilling, sepulchral laugh. "You useless, puny mortal," it cries. "Did you really think that there was any way on earth you could stop me? I have lived and thrived for over four hundred years -- not even Death can claim me!".

You slide a finger to cover the the first hole.

"You sabotaged my dimensional beacon -- I will build another. You drove me from my host body -- I will find another. What next? Will you track down my disciples, one by one, and kill them all? Will you set this whole town to the torch?".

The first hole is already closed.

"There will be more towns, woman, and more bodies, and more disciples, and always will I be there. And there is NOTHING YOU CAN DO TO STOP ME!".

>close hole 1
The first hole is already closed.

"It would almost be too kind to kill you," muses the ghost. "I've half a mind to simply let you go, and spend the next four hundred years tormenting and violating your future daughters and grand-daughters through the next twelve generations. You've only got one amulet, you know; you can't protect all your children at once.".

>close hole 5
The first hole is already closed.

"But no," it finally says. "After all you've done, I think that death would be most appropriate. But just to make sure you suffer, I think I'll start with your beloved husband.".

* * *

>take flute. close hole 1. close hole 6.
(putting the keyring into the trench coat to make room)
You slip the keyring into the pocket of your trench coat.

Taken.

The ghost lets out a chilling, sepulchral laugh. "You useless, puny mortal," it cries. "Did you really think that there was any way on earth you could stop me? I have lived and thrived for over four hundred years -- not even Death can claim me!".

You slide a finger to cover the the first hole.

"You sabotaged my dimensional beacon -- I will build another. You drove me from my host body -- I will find another. What next? Will you track down my disciples, one by one, and kill them all? Will you set this whole town to the torch?".

You slide a finger to cover the the sixth hole.

"There will be more towns, woman, and more bodies, and more disciples, and always will I be there. And there is NOTHING YOU CAN DO TO STOP ME!".

>blow flute
FLUTE SOUND = s.
CLOSED HOLES = first hole and sixth hole.
FLUTE EFFECT = 0.
The flute emits an odd mixture of metallic, warbling notes which intertwine and harmonize eerily with each other.

The columns" vibrations seem to grow momentarily stronger while the flute's sound lingers, their dissonant ringing resonating strangely with the warbling, metallic notes.

"It would almost be too kind to kill you," muses the ghost. "I've half a mind to simply let you go, and spend the next four hundred years tormenting and violating your future daughters and grand-daughters through the next twelve generations. You've only got one amulet, you know; you can't protect all your children at once.".

>open sixth. close fifth.
You remove your finger from the sixth hole.

"But no," it finally says. "After all you've done, I think that death would be most appropriate. But just to make sure you suffer, I think I'll start with your beloved husband.".

You slide a finger to cover the the fifth hole.

Tendrils of ectoplasm snake out from the ghost's outstretched arms and wrap themselves around Michael, who begins flailing weakly. You rush to help him, but Michael is powerless and you are too slow to prevent the tendrils from pushing into his mouth and nostrils, stopping his throat and filling his lungs with noxious gas. You work desperately, trying to administer CPR even as his body stiffens and his face turns blue; but in the end, there is nothing you can do. Michael gags one last time, arches his back, and dies in your arms. Thin, thread-like streamers of mist ooze from his mouth along with his final breath.

"You're next," chuckles the ghost..

>blow flute
FLUTE SOUND = s.
CLOSED HOLES = first hole and fifth hole.
FLUTE EFFECT = 2.
The strange harmony of the flute blends with the atonal ringing of the two columns, and the three sounds suddenly grow stronger, resonating with and reinforcing one another, intertwining like a dissonant, invisible braid. The sound increases in volume, piercing your eardrums and causing the very air to shimmer.

Suddenly the air above the altar begins to ripple as though with extreme heat. The very fabric of space seems to twist and buckle between the two columns; and then, with a sound like a wet sheet being torn slowly down the middle, the fabric splits.

You are immediately swept off your feet by a powerful sucking vacuum, pulling everything within reach toward the portal. Dust and debris; bones and loose rock from the burial niches; everything not nailed down goes flying across the temple and into the all-devouring maw hovering over the altar-stone. Desperately, you wedge your fingers into a crack in the floor; with the other hand you grasp hold of Michael's pants leg and hang on for dear life.

Verlac is caught like a gossamer thread in a tornado. Frantically he claws at the air, but as an insubstantial ghost there is nothing for him to hang on to. Shrieking and cursing, he is dragged inexorably back, closer and closer to the portal, until the suction draws his corpus out into a long, trailing ribbon, like an unraveling cable-knit sweater -- and in the next moment he is gone forever, sucked into whatever alien dimension lies beyond that horrible rift.

Painstakingly, you pry your stiff, bleeding fingers out of the crack and roll over. The rift is gone. The air is normal, and the columns are ringing quietly, as if nothing had happened.

The tendrils wriggle toward you like eels, and you barely resist as they embrace you. There is nothing left to fight for. As the mist creeps down your throat and begins to drown you in its foetid breath of graves, you welcome the coming oblivion.

    *** You have lost everything ***

In that game you scored 18 out of a possible 0, in 94 turns.

Would you like to RESTART, RESTORE a saved game, QUIT or UNDO the last command?

* * *

>z
Time passes.

The obelisk is still glowing brightly.

>z
Time passes.

In the distance, you can hear the lonesome keening of a train whistle drifting on the wind.

The green phosphorescence fades away; the obelisk is only dark stone once again.

>undo
Town Square
[Previous turn undone.]

>touch obelisk
As your fingers touch the gore-streaked stone, the green light grows brighter, fanning out to envelope you. The odor of rotting fruit briefly assails your nostrils; your vision streaks, then blurs; there is the sound of rushing air, and when your eyes clear, you are somewhere else...

Burial Mound
The cave is lined, floor to ceiling, with mummified human corpses. Shrunken and desiccated, they lie in jumbled heaps inside irregularly carved niches. Carvings cover the rock walls in between the niches -- grotesque, leering faces too horrible even to look upon, their features twitching and smirking in the wavering light that sifts down from above.

And dominating the center of the chamber: a dark monolith rising up through the green, murky light -- what you first took to be a large, supporting pillar, you now realize can only be the true base of the town square obelisk.

At the narrower, northern end of the vaguely egg-shaped cavern sits a massive stone altar, flanked on either side by a pair of strange, vibrating columns.

Michael -- or rather, the thing that has possessed Michael's body -- is standing here.

Suddenly Michael lunges forward and grabs your arms. He shakes you, causing your head to whip back and forth and your teeth to click painfully together.

"Bitch -- " he hisses, " -- rotten, filthy bitch -- you never give up, do you? You've foiled me for the last time! There's no way to fix what you've undone tonight, but by all the unholy spawn of darkness I will put you in a stone cold place for it!!" And his hands lock tightly around your throat and begin to squeeze.

>show ring to michael
Michael looks up, startled, then realizes it's you and smiles. "Hi, hon," he says, closing the book and stretching. Then he glances at his watch. "Good grief, what happened to the time? I'm so sorry -- I just lost track." He smiles sheepishly.

"Well?" he asks. "Did you get the keys?"

Grimly, Michael continues to strangle you...

>scenes
Scene 'Entire Game' playing (for 87 mins now)
Scene 'Day 1' playing (for 87 mins now)
Scene 'Michael Reads' playing (for 87 mins now)
Scene 'Day 4' playing (for 87 mins now)
Scene 'Loony Binned' ended
Scene 'Mob Justice' ended
Scene 'Will Attacks' ended
Scene 'Michael Inspects' ended
Scene 'Michael Demands' ended
Scene 'Michael Summons' ended
Scene 'Abandon Ship' ended
Scene 'Michael Flees' playing (for 12 mins now)
(Scene monitoring now switched on. Type "scenes off" to switch it off again.)

>show ring to michael
Michael nods distractedly. He doesn't seem to be listening to you.

His iron grip has closed your throat completely; you cannot even draw in enough breath to cry for mercy. As inky black flowers bloom in your vision, you desperately search Michael's eyes for some sign, some glint of the person he once was, the husband you knew and loved. Sadly, you find nothing. As drool from his crazed rictus grin spatters down on your face and the world goes black, the last sight you see is the madness burning in Michael's red-rimmed eyes.

    *** You have died ***

In that game you scored 8 out of a possible 0, in 88 turns.

Would you like to RESTART, RESTORE a saved game, QUIT or UNDO the last command?

>restore
Restore failed.

Would you like to RESTART, RESTORE a saved game, QUIT or UNDO the last command?

* * *

>take flute
(putting the keyring into the trench coat to make room)
You slip the keyring into the pocket of your trench coat.

Taken.

The ghost lets out a chilling, sepulchral laugh. "You useless, puny mortal," it cries. "Did you really think that there was any way on earth you could stop me? I have lived and thrived for over four hundred years -- not even Death can claim me!".

>close first hole
You slide a finger to cover the the first hole.

"You sabotaged my dimensional beacon -- I will build another. You drove me from my host body -- I will find another. What next? Will you track down my disciples, one by one, and kill them all? Will you set this whole town to the torch?".

>close fifth hole
You slide a finger to cover the the fifth hole.

"There will be more towns, woman, and more bodies, and more disciples, and always will I be there. And there is NOTHING YOU CAN DO TO STOP ME!".

>blow flute
"It would almost be too kind to kill you," muses the ghost. "I've half a mind to simply let you go, and spend the next four hundred years tormenting and violating your future daughters and grand-daughters through the next twelve generations. You've only got one amulet, you know; you can't protect all your children at once.".

>g
"But no," it finally says. "After all you've done, I think that death would be most appropriate. But just to make sure you suffer, I think I'll start with your beloved husband.".

>l
Burial Mound
The cave is lined, floor to ceiling, with mummified human corpses. Shrunken and desiccated, they lie in jumbled heaps inside irregularly carved niches. Carvings cover the rock walls in between the niches -- grotesque, leering faces too horrible even to look upon, their features twitching and smirking in the wavering light that sifts down from above.

And dominating the center of the chamber: a dark monolith rising up through the green, murky light -- what you first took to be a large, supporting pillar, you now realize can only be the true base of the town square obelisk.

At the narrower, northern end of the vaguely egg-shaped cavern sits a massive stone altar, flanked on either side by a pair of strange, vibrating columns.

The disembodied ghost of Croseus Verlac floats before you, howling its rage.

Michael -- or rather, the thing that has possessed Michael's body -- is standing here.

Tendrils of ectoplasm snake out from the ghost's outstretched arms and wrap themselves around Michael, who begins flailing weakly. You rush to help him, but Michael is powerless and you are too slow to prevent the tendrils from pushing into his mouth and nostrils, stopping his throat and filling his lungs with noxious gas. You work desperately, trying to administer CPR even as his body stiffens and his face turns blue; but in the end, there is nothing you can do. Michael gags one last time, arches his back, and dies in your arms. Thin, thread-like streamers of mist ooze from his mouth along with his final breath.

"You're next," chuckles the ghost..

>z
Time passes.

The tendrils wriggle toward you like eels, and you barely resist as they embrace you. There is nothing left to fight for. As the mist creeps down your throat and begins to drown you in its foetid breath of graves, you welcome the coming oblivion.

    *** You have lost everything ***

In that game you scored 18 out of a possible 0, in 94 turns.

Would you like to RESTART, RESTORE a saved game, QUIT or UNDO the last command?

>restore
Restore failed.

Would you like to RESTART, RESTORE a saved game, QUIT or UNDO the last command?

>restart
Informhead
An Interactive Fiction by Ed Peters
Release 1 / Serial number 230628 / Inform 7 v10.1.2 / D

Outside the Real Estate Office
A grim little cul-de-sac, tucked away in a corner of the claustrophobic tangle of narrow, twisting avenues that largely constitute the older portion of Anchorhead. Like most of the streets in this city, it is ancient, shadowy, and leads essentially nowhere. The lane ends here at the real estate agent's office, which lies to the east, and winds its way back toward the center of town to the west. A narrow, garbage-choked alley opens to the southeast.

>day4
Padded Cell
You are in a padded cell, the kind typically reserved for raving lunatics. The room is barely eight feet by eight feet square, with walls and floor of concrete covered with thick, quilted padding. The door in the west wall is also covered with padding, except for a tiny observation window about five feet up, from which a feeble light trickles in.

* * *

>showme flute
(the strange metal flute)
strange metal flute - thing
    first hole (part of strange metal flute) - fhole
    second hole (part of strange metal flute) - fhole
    third hole (part of strange metal flute) - fhole
    fourth hole (part of strange metal flute) - fhole
    fifth hole (part of strange metal flute) - fhole
    sixth hole (part of strange metal flute) - fhole
location: in the trench coat carried by yourself in the Burial Mound
unlit, inedible, portable, seen, familiar; singular-named, improper-named; unlocked
description: "It appears to be some kind of wind instrument, fashioned out of ornately carved, greenish metal. Seven holes of varying sizes are drilled along the top."
initial appearance: "Your flute lies on the bench, waiting for you."
last turn examined: -2
printing: "blank"
consult table: (the empty table)
consult empty message: "The strange metal flute doesn't seem to have any information about that."
printed name: "strange metal flute"
printed plural name: none
indefinite article: none
list grouping key: none
author: none
title: none
topic: 678182

* * *

>z
Time passes.

The ghost lets out a chilling, sepulchral laugh. "You useless, puny mortal," it cries. "Did you really think that there was any way on earth you could stop me? I have lived and thrived for over four hundred years -- not even Death can claim me!".

>z
Time passes.

"You sabotaged my dimensional beacon -- I will build another. You drove me from my host body -- I will find another. What next? Will you track down my disciples, one by one, and kill them all? Will you set this whole town to the torch?".

>z
Time passes.

"There will be more towns, woman, and more bodies, and more disciples, and always will I be there. And there is NOTHING YOU CAN DO TO STOP ME!".

>z
Time passes.

"It would almost be too kind to kill you," muses the ghost. "I've half a mind to simply let you go, and spend the next four hundred years tormenting and violating your future daughters and grand-daughters through the next twelve generations. You've only got one amulet, you know; you can't protect all your children at once.".

* * *

Informhead
An Interactive Fiction by Ed Peters
Release 1 / Serial number 230628 / Inform 7 v10.1.2 / D

Outside the Real Estate Office
A grim little cul-de-sac, tucked away in a corner of the claustrophobic tangle of narrow, twisting avenues that largely constitute the older portion of Anchorhead. Like most of the streets in this city, it is ancient, shadowy, and leads essentially nowhere. The lane ends here at the real estate agent's office, which lies to the east, and winds its way back toward the center of town to the west. A narrow, garbage-choked alley opens to the southeast.

>go4
Padded Cell
You are in a padded cell, the kind typically reserved for raving lunatics. The room is barely eight feet by eight feet square, with walls and floor of concrete covered with thick, quilted padding. The door in the west wall is also covered with padding, except for a tiny observation window about five feet up, from which a feeble light trickles in.

>i
You are wearing a strait jacket, your clothes and your wedding ring.

>kick door
You take a few steps back, draw a deep breath, and hurl your body at the door. It shudders violently, and you thought you felt something give.

>g
With a defiant shout, you launch your body at the door. Something snaps (the door? you think incoherently, or your shoulder?), and the door flies open, sending you sprawling out into the hallway.

Hallway
A grim hallway of concrete and industrial green tiles. This is the north end; the hallway runs south from here. Doors lead east and west, and a narrow, barred window to the north looks out onto the dark corner outside.

A shard of glass from the broken window lies on the floor.

>take shard
Painstakingly, you get down on your knees and very, very carefully pick up the shard of glass with your teeth.

[Your score has just gone up by two points.]

>put shard in crack
You wedge the shard of glass into the crack, its sharp edge pointing outward.

>cut jacket with shard
Carefully, you lean back against the wall and start shrugging your shoulders against the jutting glass shard. After what seems like an eternity, you feel the straps begin to fray and loosen, until suddenly the strait jacket grows slack and slips free. You shake the horrible garment off in disgust, giving it a vicious kick for good measure as you gingerly rub feeling back into your arms.

>i
You are wearing your clothes and your wedding ring.

>x closet
This looks like it might have been a janitor's closet, although all the cleaning equipment has been cleared away, leaving only a small, dingy alcove.

>open it
You open the closet, revealing your trenchcoat, your keyring, your umbrella, a flashlight, a hooded robe and mirror labeled #2.

>take all from closet
trenchcoat: Taken.
keyring: Taken.
umbrella: Taken.
flashlight: Taken.
hooded robe: You shake the cloth out, revealing it to be a hooded robe.
mirror labeled #2: (putting the keyring into the trenchcoat to make room)
You slip the keyring into the pocket of your trenchcoat.

Taken.

>wear coat
You put on the trenchcoat.

>put all in pockets
mirror labeled #2: You slip mirror labeled #2 into the pocket of your trenchcoat.
hooded robe: No matter how tightly you roll up the heavy robe, it is still too big to fit in your pocket.
flashlight: You slip the flashlight into the pocket of your trenchcoat.
umbrella: You slip the umbrella into the pocket of your trenchcoat.

>i
You are wearing your trenchcoat, your clothes and your wedding ring.

In addition, you are holding a hooded robe.

The pockets of your trenchcoat contain your umbrella, a flashlight, mirror labeled #2 and your keyring.

Your keyring contains a cellar key, a house key, an old-fashioned brass key, an old-fashioned iron key, a small steel key, a small copper key, a long steel key and a tarnished bronze key.

>snap
That's not a verb I recognise.

* * *

>i
You are wearing a strait jacket, your clothes and your wedding ring.

>l
Padded Cell
You are in a padded cell, the kind typically reserved for raving lunatics. The room is barely eight feet by eight feet square, with walls and floor of concrete covered with thick, quilted padding. The door in the west wall is also covered with padding, except for a tiny observation window about five feet up, from which a feeble light trickles in.

>take door
Unfortunately, that would require the use of your arms.

>kick door
That's not a verb I recognise.

* * *

Informhead
An Interactive Fiction by Ed Peters
Release 1 / Serial number 230628 / Inform 7 v10.1.2 / D

Outside the Real Estate Office
A grim little cul-de-sac, tucked away in a corner of the claustrophobic tangle of narrow, twisting avenues that largely constitute the older portion of Anchorhead. Like most of the streets in this city, it is ancient, shadowy, and leads essentially nowhere. The lane ends here at the real estate agent's office, which lies to the east, and winds its way back toward the center of town to the west. A narrow, garbage-choked alley opens to the southeast.

>purloin flute
[Purloined.]

>play flute
FLUTE SOUND = s.
You blow an open chord into the little flute, and it resonates with an eerie, metallic warble. The sound lingers in the air for a moment, then gently fades away.

>close hole 1
You slide a finger to cover the the first hole.

>play flute
FLUTE SOUND = s.
The flute emits an eerie, almost sub-sonic note. The sound lingers in the air for a moment, then gently fades away.

>close hole 6
You slide a finger to cover the the sixth hole.

>play flute
FLUTE SOUND = s.
The flute emits an odd mixture of metallic, warbling notes which intertwine and harmonize eerily with each other. The sound lingers in the air for a moment, then gently fades away.

>restart
Are you sure you want to restart?

>y
Informhead
An Interactive Fiction by Ed Peters
Release 1 / Serial number 230628 / Inform 7 v10.1.2 / D

Outside the Real Estate Office
A grim little cul-de-sac, tucked away in a corner of the claustrophobic tangle of narrow, twisting avenues that largely constitute the older portion of Anchorhead. Like most of the streets in this city, it is ancient, shadowy, and leads essentially nowhere. The lane ends here at the real estate agent's office, which lies to the east, and winds its way back toward the center of town to the west. A narrow, garbage-choked alley opens to the southeast.

>day4
Padded Cell
You are in a padded cell, the kind typically reserved for raving lunatics. The room is barely eight feet by eight feet square, with walls and floor of concrete covered with thick, quilted padding. The door in the west wall is also covered with padding, except for a tiny observation window about five feet up, from which a feeble light trickles in.

* * *

>take flute
(putting the keyring into the trench coat to make room)
You slip the keyring into the pocket of your trench coat.

Taken.

The ghost lets out a chilling, sepulchral laugh. "You useless, puny mortal," it cries. "Did you really think that there was any way on earth you could stop me? I have lived and thrived for over four hundred years -- not even Death can claim me!".

>close hole 1
You slide a finger to cover the the first hole.

"You sabotaged my dimensional beacon -- I will build another. You drove me from my host body -- I will find another. What next? Will you track down my disciples, one by one, and kill them all? Will you set this whole town to the torch?".

>close hole 6
You slide a finger to cover the the sixth hole.

"There will be more towns, woman, and more bodies, and more disciples, and always will I be there. And there is NOTHING YOU CAN DO TO STOP ME!".

>play flute
FLUTE SOUND = s.
FLUTE EFFECT = 0.
The flute emits an odd mixture of metallic, warbling notes which intertwine and harmonize eerily with each other.

The columns" vibrations seem to grow momentarily stronger while the flute's sound lingers, their dissonant ringing resonating strangely with the warbling, metallic notes.

"It would almost be too kind to kill you," muses the ghost. "I've half a mind to simply let you go, and spend the next four hundred years tormenting and violating your future daughters and grand-daughters through the next twelve generations. You've only got one amulet, you know; you can't protect all your children at once.".

* * *

Informhead
An Interactive Fiction by Ed Peters
Release 1 / Serial number 230628 / Inform 7 v10.1.2 / D

Outside the Real Estate Office
A grim little cul-de-sac, tucked away in a corner of the claustrophobic tangle of narrow, twisting avenues that largely constitute the older portion of Anchorhead. Like most of the streets in this city, it is ancient, shadowy, and leads essentially nowhere. The lane ends here at the real estate agent's office, which lies to the east, and winds its way back toward the center of town to the west. A narrow, garbage-choked alley opens to the southeast.

>purloin light
[Purloined.]

>gonear black tome
Darkness
It is pitch dark, and you can't see a thing.

>turn on light
You switch the flashlight on.

Chapel
Broken shards from the shattered the stained glass windows grits under your feet as you step around rows of overturned pews. The dust and cobwebs have been busy here, reclaiming another bit of this town's abandoned history. To the west lies the vestibule; to the east, a small doorway behind the pulpit leads to the back of the church.

The big wooden cross that once hung above the pulpit has fallen, split in half.

On the pulpit is a huge black tome.

>e
Behind the Chapel
This little room behind the chapel is hardly bigger than a broom closet. A ladder bolted to the wall leads up through a hatch, presumably up into the steeple.

>u
Steeple
A tiny space inside the tip of the church's steeple, barely five feet across, the walls tapering to only two feet across some twelve feet above your head. There is a narrow window, but it seems to have been painted black at some point. The only exit seems to be the ladder from which you just emerged.

An old length of rope dangles down from a square hole cut in the ceiling.

>u
You haul yourself up onto the rope, bringing your whole weight to bear. It holds for about three seconds -- then there is a sharp snap from above you and a muffled clank. The rope falls, spilling you to the floor amidst an untidy tangle of coils.

>l
Steeple
A tiny space inside the tip of the church's steeple, barely five feet across, the walls tapering to only two feet across some twelve feet above your head. There is a narrow window, but it seems to have been painted black at some point. The only exit seems to be the ladder from which you just emerged.

You can see a length of rope here.

>take rope
[** Programming error: tried to read (something) **]
Foo.

* * *

>purloin light
[Purloined.]

>gonear luggage
Foyer
Although it appears spacious from the outside, the house's interior feels cramped and gloomy. The walls seem too close together; the ceiling is too high. The doorways, leading in several directions, are narrow and filled with shadows, and the stairs leading up to the second floor are steep and rickety. This is not a house that makes you feel welcome. It is a house that makes you feel tiny and timid, and afraid of dark places. It is a house that makes you feel alone.

Carelessly stacked in a towering heap in the middle of the room are all your luggage and belongings, which you had sent ahead through a moving company before driving up to Massachusetts. Everything you own is boxed away and piled up in the middle of the floor. The reality of this move finally slams home as you stare at the sprawling jumble of stuff, and suddenly you feel very lost and adrift.

Night has now undeniably fallen, and the house is very, very dark. There is probably just enough residual ambience to feel your way upstairs to the bedroom, but the rest of the house is a tenebrous maze of shadows, and any exploring would probably best be done in the morning.

>turn on light
You switch the flashlight on.

>n
Back Hall
A short hallway, connecting rooms to the east, west and south.

>w
Kitchen
Where once pots and skillets and various utensils hung in profusion, the kitchen walls are now merely ranks of dusty cabinets and a forest of empty hooks. Doorways lead east and south, a small pantry lies to the northwest, and the back door to the north leads out of the house.

An odd feeling of gloom overtakes you momentarily, and you find yourself thinking about the Verlac family's personal effects -- the everyday mundanities, such as kitchen utensils. Were they thrown out, or donated to charity, or auctioned off as grisly souvenirs? What about the canned goods? Did anyone think to take them? The cabinets might even still be stocked. Morbidly, you wonder what Mrs. Edward Verlac might have been cooking for dinner the night her husband blew her head off..

>nw
Pantry
The pantry is empty save for a layer of dust on the shelves. A door to the south leads down to the cellar, or you can return to the kitchen to the southeast.

Leaning in the corner is an old broom.

>se
Kitchen
Where once pots and skillets and various utensils hung in profusion, the kitchen walls are now merely ranks of dusty cabinets and a forest of empty hooks. Doorways lead east and south, a small pantry lies to the northwest, and the back door to the north leads out of the house.

>restart
Are you sure you want to restart?

>y
Informhead
An Interactive Fiction by Ed Peters
Release 1 / Serial number 230617 / Inform 7 v10.1.2 / D

Outside the Real Estate Office
A grim little cul-de-sac, tucked away in a corner of the claustrophobic tangle of narrow, twisting avenues that largely constitute the older portion of Anchorhead. Like most of the streets in this city, it is ancient, shadowy, and leads essentially nowhere. The lane ends here at the real estate agent's office, which lies to the east, and winds its way back toward the center of town to the west. A narrow, garbage-choked alley opens to the southeast.

* * *

>purloin light
[Purloined.]

>gonear shape
Darkness
It is pitch dark, and you can't see a thing.

>turn on light
You switch the flashlight on.

Church Cellar
Centipedes and beetles scurry away across the rotten floorboards as you shine your light across the room. Over in the corner sits a hulking shape of black metal that was probably once a wood-burning furnace; aside from that, the cellar looks empty. A dark alcove, the shadows within too thick to see through, opens in the west wall, and a trap door in the ceiling leads back up to the outside.

At the very edge of your light's glow, you can just make out a horribly suggestive shape lying in the shadows behind the furnace.

>w
Empty Stairwell
This alcove used to house a stairwell leading up and down; now it contains only a few rotted boards jutting from the walls and an empty shaft dropping down out of sight. Above you hang the broken-off remains of the stairs leading up to the ground floor, the last shattered riser only a couple of tantalizing feet out of reach.

>i
You are wearing your clothes, your trenchcoat and your wedding ring.

In addition, you are holding a flashlight, your umbrella and your keyring.

>put all in coat
flashlight: You slip the flashlight into the pocket of your trenchcoat.
umbrella: You slip the umbrella into the pocket of your trenchcoat.
keyring: You slip the keyring into the pocket of your trenchcoat.

>jump
You take a few steps back, draw in a deep breath, and make a dash for the edge. At the last possible second you jump, sailing out over the pit as you make a desperate grab for the bottom riser...

... and catch it.

The riser bends ominously under your weight but doesn't give. Panting, you haul yourself up onto the creaking stairs.

Broken Stairs
The stairs stop short about seven feet shy of the basement floor, the bottom-most steps hanging suspended over an empty shaft that descends beyond sight into the shadowy depths. What's left of the structure creaks and shifts uneasily under your feet. At the top of the stairs to the north, a doorway opens onto the ground floor of the church.

>u
Vestibule
A dim antechamber, opening onto the main chapel to the east. To the west, the main doors to the church have been solidly nailed shut, and through a shadowy doorway to the south you can see stairs leading down.

Piled in one dusty corner is a heap of old cloth.

>e
Chapel
Broken shards from the shattered the stained glass windows grits under your feet as you step around rows of overturned pews. The dust and cobwebs have been busy here, reclaiming another bit of this town's abandoned history. To the west lies the vestibule; to the east, a small doorway behind the pulpit leads to the back of the church.

The big wooden cross that once hung above the pulpit has fallen, split in half.

On the pulpit is a huge black tome.

>e
Behind the Chapel
This little room behind the chapel is hardly bigger than a broom closet. A ladder bolted to the wall leads up through a hatch, presumably up into the steeple.

You hear a faint, echoing crash from the direction of the Vestibule.

>u
Steeple
A tiny space inside the tip of the church's steeple, barely five feet across, the walls tapering to only two feet across some twelve feet above your head. There is a narrow window, but it seems to have been painted black at some point. The only exit seems to be the ladder from which you just emerged.

An old length of rope dangles down from a square hole cut in the ceiling.

* * *

>u
You haul yourself up onto the rope, bringing your whole weight to bear. It holds for about three seconds -- then there is a sharp snap from above you and a muffled clank. The rope falls, spilling you to the floor amidst an untidy tangle of coils.

>take rope
[** Programming error: tried to read (something) **]
Taken.

>i
You are wearing your clothes, your trenchcoat and your wedding ring.

In addition, you are holding a length of rope.

The pockets of your trenchcoat contain your keyring, your umbrella and a flashlight.

>drop rope
Dropped.

>l
Steeple
A tiny space inside the tip of the church's steeple, barely five feet across, the walls tapering to only two feet across some twelve feet above your head. There is a narrow window, but it seems to have been painted black at some point. The only exit seems to be the ladder from which you just emerged.

You can see a length of rope here.

>take rope
[** Programming error: tried to read (something) **]
Taken.

>drop rope
Dropped.

>rules
Rules tracing now switched on. Type "rules off" to switch it off again, or "rules all" to include even rules which do not apply.

[Rule "parse command rule" applies.]

>take rope
[Rule "declare everything initially unmentioned rule" applies.]
[Rule "generate action rule" applies.]
[Rule "announce items from multiple object lists rule" applies.]
[Rule "set pronouns from items from multiple object lists rule" applies.]
[Rule "before stage rule" applies.]
[Rule "basic visibility rule" applies.]
[Rule "basic accessibility rule" applies.]
[Rule "access through barriers rule" applies.]
[Rule "keychain-aware carrying requirements rule" applies.]
[Rule "instead stage rule" applies.]

[** Programming error: tried to read (something) **]
[Rule "requested actions require persuasion rule" applies.]
[Rule "carry out requested actions rule" applies.]
[Rule "descend to specific action-processing rule" applies.]
[Rule "work out details of specific action rule" applies.]
[Rule "investigate player's awareness before action rule" applies.]
[Rule "player aware of his own actions rule" applies.]
[Rule "check stage rule" applies.]
[Rule "can't take yourself rule" applies.]
[Rule "can't take other people rule" applies.]
[Rule "can't take component parts rule" applies.]
[Rule "can't take people's possessions rule" applies.]
[Rule "can't take items out of play rule" applies.]
[Rule "can't take what you're inside rule" applies.]
[Rule "can't take what's already taken rule" applies.]
[Rule "can't take scenery rule" applies.]
[Rule "can only take things rule" applies.]
[Rule "can't take what's fixed in place rule" applies.]
[Rule "use player's holdall to avoid exceeding carrying capacity rule" applies.]
[Rule "can't exceed carrying capacity rule" applies.]
[Rule "carry out stage rule" applies.]
[Rule "new carry out taking rule" applies.]
[Rule "after stage rule" applies.]
[Rule "investigate player's awareness after action rule" applies.]
[Rule "report stage rule" applies.]
[Rule "new report taking rule" applies.]
Taken.
[Rule "last specific action-processing rule" applies.]

[Rule "A first turn sequence rule" applies.]
[Rule "scene change machinery rule" applies.]
[Rule "every turn stage rule" applies.]
[Rule "timed events rule" applies.]
[Rule "advance time rule" applies.]
[Rule "update chronological records rule" applies.]
[Rule "A last turn sequence rule" applies.]
[Rule "scene change machinery rule" applies.]
[Rule "adjust light rule" applies.]
[Rule "note object acquisitions rule" applies.]
[Rule "notify score changes rule" applies.]
[Rule "parse command rule" applies.]

* * *

>purloin light
[Purloined.]

>turn it on
You switch the flashlight on.

>gonear black tome
Chapel
Broken shards from the shattered the stained glass windows grits under your feet as you step around rows of overturned pews. The dust and cobwebs have been busy here, reclaiming another bit of this town's abandoned history. To the west lies the vestibule; to the east, a small doorway behind the pulpit leads to the back of the church.

The big wooden cross that once hung above the pulpit has fallen, split in half.

On the pulpit is a huge black tome.

>e
Behind the Chapel
This little room behind the chapel is hardly bigger than a broom closet. A ladder bolted to the wall leads up through a hatch, presumably up into the steeple.

* * *

>l
Steeple
A tiny space inside the tip of the church's steeple, barely five feet across, the walls tapering to only two feet across some twelve feet above your head. There is a narrow window, but it seems to have been painted black at some point. The only exit seems to be the ladder from which you just emerged.

You can see a length of rope here.

>take rope
[** Programming error: tried to read (something) **]
foo-1foo-3
foo-4foo-5foo-6Taken.

* * *

Informhead
An Interactive Fiction by Ed Peters
Release 1 / Serial number 230628 / Inform 7 v10.1.2 / D

Outside the Real Estate Office
A grim little cul-de-sac, tucked away in a corner of the claustrophobic tangle of narrow, twisting avenues that largely constitute the older portion of Anchorhead. Like most of the streets in this city, it is ancient, shadowy, and leads essentially nowhere. The lane ends here at the real estate agent's office, which lies to the east, and winds its way back toward the center of town to the west. A narrow, garbage-choked alley opens to the southeast.

>purloin light. turn it on. gonear black tome. e. u.
[Purloined.]

I only understood you as far as wanting to turn the flashlight.

>turn on light. gonear black tome. e. u.
You switch the flashlight on.

Chapel
Broken shards from the shattered the stained glass windows grits under your feet as you step around rows of overturned pews. The dust and cobwebs have been busy here, reclaiming another bit of this town's abandoned history. To the west lies the vestibule; to the east, a small doorway behind the pulpit leads to the back of the church.

The big wooden cross that once hung above the pulpit has fallen, split in half.

On the pulpit is a huge black tome.

Behind the Chapel
This little room behind the chapel is hardly bigger than a broom closet. A ladder bolted to the wall leads up through a hatch, presumably up into the steeple.

Steeple
A tiny space inside the tip of the church's steeple, barely five feet across, the walls tapering to only two feet across some twelve feet above your head. There is a narrow window, but it seems to have been painted black at some point. The only exit seems to be the ladder from which you just emerged.

An old length of rope dangles down from a square hole cut in the ceiling.

>take rope
You tug on the rope, but it seems firmly attached to whatever it's tied to at the top of the steeple.

>pull it
You tug on the rope, but it seems firmly attached to whatever it's tied to at the top of the steeple.

>l
Steeple
A tiny space inside the tip of the church's steeple, barely five feet across, the walls tapering to only two feet across some twelve feet above your head. There is a narrow window, but it seems to have been painted black at some point. The only exit seems to be the ladder from which you just emerged.

An old length of rope dangles down from a square hole cut in the ceiling.

>u
You haul yourself up onto the rope, bringing your whole weight to bear. It holds for about three seconds -- then there is a sharp snap from above you and a muffled clank. The rope falls, spilling you to the floor amidst an untidy tangle of coils.

* * *

>take rope
[** Programming error: tried to read (something) **]
Taken.

>x rope.
It's about twenty feet long, frayed in a few places but still sturdy enough.

>restart
Are you sure you want to restart?

>y
Informhead
An Interactive Fiction by Ed Peters
Release 1 / Serial number 230615 / Inform 7 v10.1.2 / D

Outside the Real Estate Office
A grim little cul-de-sac, tucked away in a corner of the claustrophobic tangle of narrow, twisting avenues that largely constitute the older portion of Anchorhead. Like most of the streets in this city, it is ancient, shadowy, and leads essentially nowhere. The lane ends here at the real estate agent's office, which lies to the east, and winds its way back toward the center of town to the west. A narrow, garbage-choked alley opens to the southeast.

>purloin skull
[Purloined.]

>purloin flask
[Purloined.]

>purloin light
[Purloined.]

>turn on light
You switch the flashlight on.

>gonear shape
Church Cellar
Centipedes and beetles scurry away across the rotten floorboards as you shine your light across the room. Over in the corner sits a hulking shape of black metal that was probably once a wood-burning furnace; aside from that, the cellar looks empty. A dark alcove, the shadows within too thick to see through, opens in the west wall, and a trap door in the ceiling leads back up to the outside.

At the very edge of your light's glow, you can just make out a horribly suggestive shape lying in the shadows behind the furnace.

>w
Empty Stairwell
This alcove used to house a stairwell leading up and down; now it contains only a few rotted boards jutting from the walls and an empty shaft dropping down out of sight. Above you hang the broken-off remains of the stairs leading up to the ground floor, the last shattered riser only a couple of tantalizing feet out of reach.

>i
You are wearing your clothes, your trenchcoat and your wedding ring.

In addition, you are holding a flashlight, a flask, an animal's skull, your umbrella and your keyring.

>put flashlight in pocket
You slip the flashlight into the pocket of your trenchcoat.

>jump
You take a few steps back, draw in a deep breath, and make a dash for the edge. At the last possible second you jump, sailing out over the pit as you make a desperate grab for the bottom riser...

... and catch it.

Unfortunately, you lose your grip on the flask, the animal's skull, the umbrella and the keyring, and they tumble into the darkness below.

The riser bends ominously under your weight but doesn't give. Panting, you haul yourself up onto the creaking stairs.

Broken Stairs
The stairs stop short about seven feet shy of the basement floor, the bottom-most steps hanging suspended over an empty shaft that descends beyond sight into the shadowy depths. What's left of the structure creaks and shifts uneasily under your feet. At the top of the stairs to the north, a doorway opens onto the ground floor of the church.

>u
Vestibule
A dim antechamber, opening onto the main chapel to the east. To the west, the main doors to the church have been solidly nailed shut, and through a shadowy doorway to the south you can see stairs leading down.

Piled in one dusty corner is a heap of old cloth.

>i
You are wearing your clothes, your trenchcoat and your wedding ring.

The pockets of your trenchcoat contain a flashlight.

>take cloth
You shake the cloth out, revealing it to be a hooded robe.

From the stairwell behind you there is a sudden, painful shriek of nails ripping out of stone, a loud, protracted splintering, and finally a thunderous crash that seems to echo up the shaft from far below.

>put cloth in pocket
You slip the hooded robe into the pocket of your trenchcoat.

>take cloth
Taken.

>e
Chapel
Broken shards from the shattered the stained glass windows grits under your feet as you step around rows of overturned pews. The dust and cobwebs have been busy here, reclaiming another bit of this town's abandoned history. To the west lies the vestibule; to the east, a small doorway behind the pulpit leads to the back of the church.

The big wooden cross that once hung above the pulpit has fallen, split in half.

On the pulpit is a huge black tome.

>e
Behind the Chapel
This little room behind the chapel is hardly bigger than a broom closet. A ladder bolted to the wall leads up through a hatch, presumably up into the steeple.

* * *

>u
You haul yourself up onto the rope, bringing your whole weight to bear. It holds for about three seconds -- then there is a sharp snap from above you and a muffled clank. The rope falls, spilling you to the floor amidst an untidy tangle of coils.

>take reop
You can't see any such thing.

>take rope
[** Programming error: tried to read (something) **]
Taken.

>d
Behind the Chapel
This little room behind the chapel is hardly bigger than a broom closet. A ladder bolted to the wall leads up through a hatch, presumably up into the steeple.

>w
Chapel
Broken shards from the shattered the stained glass windows grits under your feet as you step around rows of overturned pews. The dust and cobwebs have been busy here, reclaiming another bit of this town's abandoned history. To the west lies the vestibule; to the east, a small doorway behind the pulpit leads to the back of the church.

The big wooden cross that once hung above the pulpit has fallen, split in half.

On the pulpit is a huge black tome.

>w
Vestibule
A dim antechamber, opening onto the main chapel to the east. To the west, the main doors to the church have been solidly nailed shut, and through a shadowy doorway to the south you can see stairs leading down.

>s
Broken Stairs
The stairs are completely gone, now. All that's left is a narrow ledge overlooking an empty shaft, and a fair portion of the railing still nailed to the wall.

>tie rope to stairs
There's no good spot on the bstair to tie the rope to.

* * *

Informhead
An Interactive Fiction by Ed Peters
Release 1 / Serial number 230628 / Inform 7 v10.1.2 / D

Outside the Real Estate Office
A grim little cul-de-sac, tucked away in a corner of the claustrophobic tangle of narrow, twisting avenues that largely constitute the older portion of Anchorhead. Like most of the streets in this city, it is ancient, shadowy, and leads essentially nowhere. The lane ends here at the real estate agent's office, which lies to the east, and winds its way back toward the center of town to the west. A narrow, garbage-choked alley opens to the southeast.

>purloin mirrors
[Purloined.]
[Purloined.]
[Purloined.]
[Purloined.]
[Purloined.]

>put oil on mirror 1
You can't see any such thing.

>purloin tin
[Purloined.]

>open tin
You open the old tin, revealing a quantity of smelly fish oil.

>put oil on mirror 1
(first taking some fish oil)
You dip your finger in and come up with a small glob of pungent fish oil.

You rub a small bit of fish oil onto the reflective surface of the mirror, leaving a barely perceptible smear.

>z
Time passes.

* * *

Informhead
An Interactive Fiction by Ed Peters
Release 1 / Serial number 230628 / Inform 7 v10.1.2 / D

Outside the Real Estate Office
A grim little cul-de-sac, tucked away in a corner of the claustrophobic tangle of narrow, twisting avenues that largely constitute the older portion of Anchorhead. Like most of the streets in this city, it is ancient, shadowy, and leads essentially nowhere. The lane ends here at the real estate agent's office, which lies to the east, and winds its way back toward the center of town to the west. A narrow, garbage-choked alley opens to the southeast.

>purloin oil
[Purloined.]

>purloin mirrors
[Purloined.]
[Purloined.]
[Purloined.]
[Purloined.]
[Purloined.]

>i
You are wearing your clothes, your trenchcoat and your wedding ring.

In addition, you are holding a rack of mirrors, mirror labeled #4, mirror labeled #3, mirror labeled #2, mirror labeled #1, a quantity of smelly fish oil, your umbrella and your keyring.

>restart
Are you sure you want to restart?

>y
Informhead
An Interactive Fiction by Ed Peters
Release 1 / Serial number 230616 / Inform 7 v10.1.2 / D

Outside the Real Estate Office
A grim little cul-de-sac, tucked away in a corner of the claustrophobic tangle of narrow, twisting avenues that largely constitute the older portion of Anchorhead. Like most of the streets in this city, it is ancient, shadowy, and leads essentially nowhere. The lane ends here at the real estate agent's office, which lies to the east, and winds its way back toward the center of town to the west. A narrow, garbage-choked alley opens to the southeast.

>purloin tin
[Purloined.]

>purloin mirrors
[Purloined.]
[Purloined.]
[Purloined.]
[Purloined.]
[Purloined.]

>open tin
You open the old tin, revealing a quantity of smelly fish oil.

>put oil on mirror 2
You rub a small bit of fish oil onto the reflective surface of the mirror, leaving a barely perceptible smear.

>x mirror 2
The mirror is perfectly round and exquisitely polished. It is very slightly concave on its reflecting surface, distorting the edges of your face as you stare into it. On the back is a small label with the number 2 written on it.

>restart
Are you sure you want to restart?

* * *

>y
Informhead
An Interactive Fiction by Ed Peters
Release 1 / Serial number 230616 / Inform 7 v10.1.2 / D

Outside the Real Estate Office
A grim little cul-de-sac, tucked away in a corner of the claustrophobic tangle of narrow, twisting avenues that largely constitute the older portion of Anchorhead. Like most of the streets in this city, it is ancient, shadowy, and leads essentially nowhere. The lane ends here at the real estate agent's office, which lies to the east, and winds its way back toward the center of town to the west. A narrow, garbage-choked alley opens to the southeast.

>purloin mirrors
[Purloined.]
[Purloined.]
[Purloined.]
[Purloined.]
[Purloined.]

>put oil on mirror 2
You can't see any such thing.

>open tin
You can't see any such thing.

>purloin tin
[Purloined.]

>open it
You open the old tin, revealing a quantity of smelly fish oil.

>drop it
Dropped.

>put oil on mirro1
You can't see any such thing.

>put oil on mirror1
You can't see any such thing.

>put oil on mirror 1
You rub a small bit of fish oil onto the reflective surface of the mirror, leaving a barely perceptible smear.

>put oil on keyring
The quantity of smelly fish oil is not a key.

* * *

Informhead
An Interactive Fiction by Ed Peters
Release 1 / Serial number 230628 / Inform 7 v10.1.2 / D

Outside the Real Estate Office
A grim little cul-de-sac, tucked away in a corner of the claustrophobic tangle of narrow, twisting avenues that largely constitute the older portion of Anchorhead. Like most of the streets in this city, it is ancient, shadowy, and leads essentially nowhere. The lane ends here at the real estate agent's office, which lies to the east, and winds its way back toward the center of town to the west. A narrow, garbage-choked alley opens to the southeast.

>purloin skull and flask and light
[Purloined.]
[Purloined.]
[Purloined.]

>turn on light. gonear shape. put light in pocket. w. jump. u.
You switch the flashlight on.

Church Cellar
Centipedes and beetles scurry away across the rotten floorboards as you shine your light across the room. Over in the corner sits a hulking shape of black metal that was probably once a wood-burning furnace; aside from that, the cellar looks empty. A dark alcove, the shadows within too thick to see through, opens in the west wall, and a trap door in the ceiling leads back up to the outside.

At the very edge of your light's glow, you can just make out a horribly suggestive shape lying in the shadows behind the furnace.

You slip the flashlight into the pocket of your trenchcoat.

Empty Stairwell
This alcove used to house a stairwell leading up and down; now it contains only a few rotted boards jutting from the walls and an empty shaft dropping down out of sight. Above you hang the broken-off remains of the stairs leading up to the ground floor, the last shattered riser only a couple of tantalizing feet out of reach.

You take a few steps back, draw in a deep breath, and make a dash for the edge. At the last possible second you jump, sailing out over the pit as you make a desperate grab for the bottom riser...

... and catch it.

Unfortunately, you lose your grip on the flask, the animal's skull, the umbrella and the keyring, and they tumble into the darkness below.

The riser bends ominously under your weight but doesn't give. Panting, you haul yourself up onto the creaking stairs.

Broken Stairs
The stairs stop short about seven feet shy of the basement floor, the bottom-most steps hanging suspended over an empty shaft that descends beyond sight into the shadowy depths. What's left of the structure creaks and shifts uneasily under your feet. At the top of the stairs to the north, a doorway opens onto the ground floor of the church.

Vestibule
A dim antechamber, opening onto the main chapel to the east. To the west, the main doors to the church have been solidly nailed shut, and through a shadowy doorway to the south you can see stairs leading down.

Piled in one dusty corner is a heap of old cloth.

>take cloth
You shake the cloth out, revealing it to be a hooded robe.

>e. e. u. u.
Chapel
Broken shards from the shattered the stained glass windows grits under your feet as you step around rows of overturned pews. The dust and cobwebs have been busy here, reclaiming another bit of this town's abandoned history. To the west lies the vestibule; to the east, a small doorway behind the pulpit leads to the back of the church.

The big wooden cross that once hung above the pulpit has fallen, split in half.

On the pulpit is a huge black tome.

You hear a faint, echoing crash from the direction of the Vestibule.

Behind the Chapel
This little room behind the chapel is hardly bigger than a broom closet. A ladder bolted to the wall leads up through a hatch, presumably up into the steeple.

Steeple
A tiny space inside the tip of the church's steeple, barely five feet across, the walls tapering to only two feet across some twelve feet above your head. There is a narrow window, but it seems to have been painted black at some point. The only exit seems to be the ladder from which you just emerged.

An old length of rope dangles down from a square hole cut in the ceiling.

You haul yourself up onto the rope, bringing your whole weight to bear. It holds for about three seconds -- then there is a sharp snap from above you and a muffled clank. The rope falls, spilling you to the floor amidst an untidy tangle of coils.

>take rope
[** Programming error: tried to read (something) **]
Taken.

* * *

>s
Broken Stairs
The stairs are completely gone, now. All that's left is a narrow ledge overlooking an empty shaft, and a fair portion of the railing still nailed to the wall.

>tie rope to railing
You tie the rope securely to the railing, letting the other end dangle down into the dark shaft.

>i
You are wearing your clothes, your trenchcoat and your wedding ring.

In addition, you are holding a hooded robe.

The pockets of your trenchcoat contain a flashlight.

>throw robe in pit
The hooded robe drops down out of sight, and a few seconds later you hear a faint splash.

>d
Gripping the end of the rope tightly, you lower yourself off the edge and shimmy down into the darkness.

Hanging from the Rope
Your feet dangle over empty space. Looking down, you can barely make out a faint glimmer of water, far below.

>jump
You take a deep breath, shut your eyes tight, say a quick prayer... and let go of the rope.

The heart-stopping plunge lasts only a second or two before you hit shockingly cold water. Your flashlight goes out and blackness envelopes you. Water rushes into your mouth and nose; the stone bottom slams into your side and nearly knocks the wind out of you... and then you find your feet, and your head breaks the surface. Blindly, you thrash about until you find higher ground, and you crawl, choking and sputtering, feeling cold brick beneath your fingers.

>l
Hanging from the Rope
Your feet dangle over empty space. Looking down, you can barely make out a faint glimmer of water, far below.

* * *

Informhead
An Interactive Fiction by Ed Peters
Release 1 / Serial number 230628 / Inform 7 v10.1.2 / D

Outside the Real Estate Office
A grim little cul-de-sac, tucked away in a corner of the claustrophobic tangle of narrow, twisting avenues that largely constitute the older portion of Anchorhead. Like most of the streets in this city, it is ancient, shadowy, and leads essentially nowhere. The lane ends here at the real estate agent's office, which lies to the east, and winds its way back toward the center of town to the west. A narrow, garbage-choked alley opens to the southeast.

>purloin tin
[Purloined.]

* * *

>open it
You open the old tin, revealing a quantity of smelly fish oil.

>purloin mirrors
[Purloined.]
[Purloined.]
[Purloined.]
[Purloined.]
[Purloined.]

>put oil on mirror 2
(first taking some fish oil)
You dip your finger in and come up with a small glob of pungent fish oil.

mirror labeled #2 does not look like it needs oiling.

You rub some fish oil onto nothing.

* * *

>purloin mirrors
[Purloined.]
[Purloined.]
[Purloined.]
[Purloined.]
[Purloined.]

>i
You are wearing your clothes, your trenchcoat and your wedding ring.

In addition, you are holding a rack of mirrors, mirror labeled #4, mirror labeled #3, mirror labeled #2, mirror labeled #1, an old tin, your umbrella and your keyring.

>open tin
You open the old tin, revealing a quantity of smelly fish oil.

>take oil
You dip your finger in and come up with a small glob of pungent fish oil.

>z
Time passes.

Not knowing what else to do with it, you wipe the nasty fish oil off on the leg of your pants.

>put oil on mirror 2
(first taking some fish oil)
You dip your finger in and come up with a small glob of pungent fish oil.

The quantity of smelly fish oil does not look like it needs oiling.

You rub some fish oil onto nothing.

* * *

>open tin
You open the old tin, revealing a quantity of smelly fish oil.

>put oil on mirror 1
1 - the quantity of smelly fish oil.
2 - mirror labeled #1.

You rub a small bit of fish oil onto the reflective surface of the mirror, leaving a barely perceptible smear.

>put oil on keyring
The quantity of smelly fish oil is not a key.

>put oil on wedding ring
1 - the quantity of smelly fish oil.
2 - the wedding ring.

(first taking some fish oil)
You dip your finger in and come up with a small glob of pungent fish oil.

The wedding ring does not look like it needs oiling.

>z
Time passes.

Not knowing what else to do with it, you wipe the nasty fish oil off on the leg of your pants.

>put oil on mirror 1
1 - the quantity of smelly fish oil.
2 - mirror labeled #1.

You rub a small bit of fish oil onto the reflective surface of the mirror, leaving a barely perceptible smear.

* * *

>open tin
You open the old tin, revealing a quantity of smelly fish oil.

>put oil on wedding ring
1 - the quantity of smelly fish oil.
2 - the wedding ring.

(first taking some fish oil)
You dip your finger in and come up with a small glob of pungent fish oil.

The wedding ring does not look like it needs oiling.

* * *

>z
Time passes.

Not knowing what else to do with it, you wipe the nasty fish oil off on the leg of your pants.

>put oil on mirror 1
1 - the quantity of smelly fish oil.
2 - mirror labeled #1.

(first taking some fish oil)
You dip your finger in and come up with a small glob of pungent fish oil.

mirror labeled #1 does not look like it needs oiling.

* * *

>purloin tin
[Purloined.]

>purloin racks
Which do you mean, the rack of mirrors or the wine racks?

>purloin rack of mirrors
[Purloined.]

>take mirror 2
Taken.

>open tin
You open the old tin, revealing a quantity of smelly fish oil.

>put oil on mirror 2
(first taking some fish oil)
You dip your finger in and come up with a small glob of pungent fish oil.

The quantity of smelly fish oil does not look like it needs oiling.

* * *

Informhead
An Interactive Fiction by Ed Peters
Release 1 / Serial number 230628 / Inform 7 v10.1.2 / D

Outside the Real Estate Office
A grim little cul-de-sac, tucked away in a corner of the claustrophobic tangle of narrow, twisting avenues that largely constitute the older portion of Anchorhead. Like most of the streets in this city, it is ancient, shadowy, and leads essentially nowhere. The lane ends here at the real estate agent's office, which lies to the east, and winds its way back toward the center of town to the west. A narrow, garbage-choked alley opens to the southeast.

>purloin tin and mirrors
[Purloined.]
[Purloined.]
[Purloined.]
[Purloined.]
[Purloined.]
[Purloined.]

>open tin
You open the old tin, revealing a quantity of smelly fish oil.

* * *

>put oil on mirror 1
(first taking some fish oil)
You dip your finger in and come up with a small glob of pungent fish oil.

You rub a small bit of fish oil onto the reflective surface of the mirror, leaving a barely perceptible smear.

>put oil on wedding ring
You rub some fish oil onto the wedding ring.

>z
Time passes.

>put oil on mirror 1
mirror labeled #1 already has fish oil on it.

>put oil on mirror 2
(first taking some fish oil)
You dip your finger in and come up with a small glob of pungent fish oil.

You rub a small bit of fish oil onto the reflective surface of the mirror, leaving a barely perceptible smear.

>z
Time passes.

Not knowing what else to do with it, you wipe the nasty fish oil off on the leg of your pants.

* * *

>open tin
You open the old tin, revealing a quantity of smelly fish oil.

>put oil on wedding ring
1 - the quantity of smelly fish oil.
2 - the wedding ring.

(first taking some fish oil)
You dip your finger in and come up with a small glob of pungent fish oil.

You rub some fish oil onto nothing.

* * *

Informhead
An Interactive Fiction by Ed Peters
Release 1 / Serial number 230628 / Inform 7 v10.1.2 / D

Outside the Real Estate Office
A grim little cul-de-sac, tucked away in a corner of the claustrophobic tangle of narrow, twisting avenues that largely constitute the older portion of Anchorhead. Like most of the streets in this city, it is ancient, shadowy, and leads essentially nowhere. The lane ends here at the real estate agent's office, which lies to the east, and winds its way back toward the center of town to the west. A narrow, garbage-choked alley opens to the southeast.

>purloin torn
(the torn journal)
[Purloined.]

>read it
It's a slim little book, no bigger than your hand, bound in imitation leather. The mice really have been at it; most of the pages have been chewed away. What's left of the journal reads:

Desperate. Went back to the old twisting lane and found only a blank wall. Without the amulet, how can I resist --

...bottles, bottles...

Getting worse. People I have never met smile knowingly at me in the street. The police believe I am a child molester, but have brought no charges against me as yet. Why? Head hurts all the time. I have turned the cellar upside-down... damn it all, where is it?

Dreamed of Father again. Dreamed of Grandfather. Those horrible, red-rimmed eyes...

 -- into the safe, finally. 46-9-27. Won't forget THAT soon. Ha!

CANNOT DISCOVER ENTRANCE IN THE CELLAR!!! Secret eludes me still but I WILL FIND IT!!! The clue is in their names, that pestilential procession of names! If I could only -- 

The text breaks off as several more pages are missing. the last fragmented entry reads:

 -- will fail. There is no recourse left. I know now what I must do. Julia --

* * *

Informhead
An Interactive Fiction by Ed Peters
Release 1 / Serial number 230628 / Inform 7 v10.1.2 / D

Outside the Real Estate Office
A grim little cul-de-sac, tucked away in a corner of the claustrophobic tangle of narrow, twisting avenues that largely constitute the older portion of Anchorhead. Like most of the streets in this city, it is ancient, shadowy, and leads essentially nowhere. The lane ends here at the real estate agent's office, which lies to the east, and winds its way back toward the center of town to the west. A narrow, garbage-choked alley opens to the southeast.

>restore
Restore failed.

* * *

>test 2a. test 2b.
(Testing.)

(Testing.)

>[1] s
Shouldn't you dress first?

>[2] e
(first getting off the bed)
You can't go that way.

>[3] s
Shouldn't you dress first?

>[4] move bed
It is fixed in place.

>[5] look in hole
You can't see any such thing.

>[6] read pages
You can't see any such thing.

>[7] drop pages
You can't see any such thing.

>[8] open box
You can't see any such thing.

>[9] take locket
You can't see any such thing.

>[10] drop box
You can't see any such thing.

>[11] n
You can't go that way.

>[12] stand
But you aren't in anything at the moment.

>[13] dress
(taking your clothes)
(taking your trenchcoat)
You slip on your clothes and your trenchcoat.

>[14] take all
keyring: Taken.
umbrella: Taken.
flask: Taken.
lantern: No one here looks as though they'd mind if you borrowed one of these lamps. Casually, you purloin the nearest one.
old tin: Taken.

>[15] look in pants
In Michael's pants is Michael's wallet.

>[16] look in wallet
In Michael's wallet is Michael's faculty card.

>[17] take card
(putting the keyring into the trenchcoat to make room)
You slip the keyring into the pocket of your trenchcoat.

Taken.

The shower suddenly stops. Quickly you palm the card, replace the wallet and arrange the pants the way you found them. A moment later Michael emerges from the bathroom, toweling his hair. "My, don't you look tempting this morning," he says, giving you a kiss. He tosses the towel back into the bathroom and gets dressed. "I think I'm going to stay home and get some writing done. I don't actually start work until tomorrow, so..." He kisses you on the cheek as he walks out into the hall. "If you go out today, see if you can find a newspaper. I want to learn as much as I can about this town."

He looks at you for a moment, and his voice becomes serious. "I love you, hon. You know that, don't you? I really want us to try and be happy here."

Then he turns and pads down the hall.

You take a deep breath as he goes. You've never lied to Michael or hidden anything from him before, ever; now, hardly two days into your new life, you're already sneaking through his wallet.

Oh yeah. You're off to a great start.

* * *

>test 2c
(Testing.)

>[1] w

Upstairs Landing
A narrow hallway runs east, from the top of the stairs down the length of the house. To the north, directly opposite the stairs, is the master bedroom.

>[2] d

Foyer
Although it appears spacious from the outside, the house's interior feels cramped and gloomy. The walls seem too close together; the ceiling is too high. The doorways, leading in several directions, are narrow and filled with shadows, and the stairs leading up to the second floor are steep and rickety. This is not a house that makes you feel welcome. It is a house that makes you feel tiny and timid, and afraid of dark places. It is a house that makes you feel alone.

Your luggage is still here, spread out all over the foyer.

>[3] w

Dining Room
Much of the elegance has faded from this room. The huge dining table running the length of it is covered with a thick gray film of dust, and the china cupboard standing against the far wall is draped in shadow. Doorways to the north and east offer little relief from the gloom. For what must be the hundredth time, you wish you could open the windows in this place.

It's a free-standing cabinet about as tall as you are, crafted of cherrywood. The double paneled doors are closed.

>[4] open cupboard
The cupboard is empty; the china must have been auctioned off, in the confusion before Michael was contacted, perhaps. Down at the bottom of the cupboard is a velvet lining, where the silverware would usually be kept.

>[5] pull lining
You pull the lining back a bit further and discover a thin, palm-sized journal tucked underneath it. Intrigued, you pull the little book free.

[Your score has just gone up by two points.]

>[6] read journal
It's a slim little book, no bigger than your hand, bound in imitation leather. The mice really have been at it; most of the pages have been chewed away. What's left of the journal reads:

Desperate. Went back to the old twisting lane and found only a blank wall. Without the amulet, how can I resist --

...bottles, bottles...

Getting worse. People I have never met smile knowingly at me in the street. The police believe I am a child molester, but have brought no charges against me as yet. Why? Head hurts all the time. I have turned the cellar upside-down... damn it all, where is it?

Dreamed of Father again. Dreamed of Grandfather. Those horrible, red-rimmed eyes...

 -- into the safe, finally. foo. Won't forget THAT soon. Ha!

CANNOT DISCOVER ENTRANCE IN THE CELLAR!!! Secret eludes me still but I WILL FIND IT!!! The clue is in their names, that pestilential procession of names! If I could only -- 

The text breaks off as several more pages are missing. the last fragmented entry reads:

 -- will fail. There is no recourse left. I know now what I must do. Julia -- 

>[7] drop journal
Dropped.

* * *

Informhead
An Interactive Fiction by Ed Peters
Release 1 / Serial number 230628 / Inform 7 v10.1.2 / D

Outside the Real Estate Office
A grim little cul-de-sac, tucked away in a corner of the claustrophobic tangle of narrow, twisting avenues that largely constitute the older portion of Anchorhead. Like most of the streets in this city, it is ancient, shadowy, and leads essentially nowhere. The lane ends here at the real estate agent's office, which lies to the east, and winds its way back toward the center of town to the west. A narrow, garbage-choked alley opens to the southeast.

>scenes
Scene 'Entire Game' playing (for 0 mins now)
Scene 'Day 1' playing (for 0 mins now)
(Scene monitoring now switched on. Type "scenes off" to switch it off again.)

>w
Narrow Street
As the lane winds along from east to west, it narrows until the steep, jagged rooftops on either side of the street practically touch each other. To the south, a side street leads across Whateley Bridge toward the center of town, and a twisting lane leads up a hill to the northwest. A short flight of steps to the north leads down to the local watering hole.

>scenes
Scene 'Entire Game' playing (for 1 mins now)
Scene 'Day 1' playing (for 1 mins now)
(Scene monitoring now switched on. Type "scenes off" to switch it off again.)

>w
Junction
To the north, a gap in the crowded press of gloomy buildings opens onto a country lane, heading out over a grassy heath. The main street continues to the east, while to the northwest, over the top of a steep rise, you can just make out the vaulted rooftops of the university.

>nw
University Court
Isolated and serene within its high, ivy-covered walls, Miskaton University represents this benighted town's single, if somewhat dubious, claim to cultural achievement. Founded some time in the early 1800s, the school's reputation and enrollment have diminished somewhat as Anchorhead drifts further and further into the abyss of provincial backwaterism. Still, it is generally recognized for its collection of folklore and esoteric mythology (one of the oldest and most extensive on the east coast). The Board of Deans was also kind enough to offer Michael a full professorship upon hearing of his recently discovered heritage and his plans to move into the estate. Ivory tower, perhaps, but at least they take care of their own.

There are numerous buildings surrounding this cobbled court, but the only one you are interested in is the library to the west, where Michael told you he'd be until he came back to the real estate agent's office to pick you up. Which, incidentally, he has not yet done.

[Scene 'Michael Reads' begins]

>restart
Are you sure you want to restart?

>yes
Informhead
An Interactive Fiction by Ed Peters
Release 1 / Serial number 230628 / Inform 7 v10.1.2 / D

Outside the Real Estate Office
A grim little cul-de-sac, tucked away in a corner of the claustrophobic tangle of narrow, twisting avenues that largely constitute the older portion of Anchorhead. Like most of the streets in this city, it is ancient, shadowy, and leads essentially nowhere. The lane ends here at the real estate agent's office, which lies to the east, and winds its way back toward the center of town to the west. A narrow, garbage-choked alley opens to the southeast.

>day4
Padded Cell
You are in a padded cell, the kind typically reserved for raving lunatics. The room is barely eight feet by eight feet square, with walls and floor of concrete covered with thick, quilted padding. The door in the west wall is also covered with padding, except for a tiny observation window about five feet up, from which a feeble light trickles in.

* * *

>touch obelisk
As your fingers touch the gore-streaked stone, the green light grows brighter, fanning out to envelope you. The odor of rotting fruit briefly assails your nostrils; your vision streaks, then blurs; there is the sound of rushing air, and when your eyes clear, you are somewhere else...

Burial Mound
The cave is lined, floor to ceiling, with mummified human corpses. Shrunken and desiccated, they lie in jumbled heaps inside irregularly carved niches. Carvings cover the rock walls in between the niches -- grotesque, leering faces too horrible even to look upon, their features twitching and smirking in the wavering light that sifts down from above.

And dominating the center of the chamber: a dark monolith rising up through the green, murky light -- what you first took to be a large, supporting pillar, you now realize can only be the true base of the town square obelisk.

At the narrower, northern end of the vaguely egg-shaped cavern sits a massive stone altar, flanked on either side by a pair of strange, vibrating columns.

Michael -- or rather, the thing that has possessed Michael's body -- is standing here.

Suddenly Michael lunges forward and grabs your arms. He shakes you, causing your head to whip back and forth and your teeth to click painfully together.

"Bitch -- " he hisses, " -- rotten, filthy bitch -- you never give up, do you? You've foiled me for the last time! There's no way to fix what you've undone tonight, but by all the unholy spawn of darkness I will put you in a stone cold place for it!!" And his hands lock tightly around your throat and begin to squeeze.

>show ring to michael
Michael is unimpressed.

Grimly, Michael continues to strangle you...

* * *

Informhead
An Interactive Fiction by Ed Peters
Release 1 / Serial number 230628 / Inform 7 v10.1.2 / D

Outside the Real Estate Office
A grim little cul-de-sac, tucked away in a corner of the claustrophobic tangle of narrow, twisting avenues that largely constitute the older portion of Anchorhead. Like most of the streets in this city, it is ancient, shadowy, and leads essentially nowhere. The lane ends here at the real estate agent's office, which lies to the east, and winds its way back toward the center of town to the west. A narrow, garbage-choked alley opens to the southeast.

>se
Alley
This narrow aperture between two buildings is nearly blocked with piles of rotting cardboard boxes and overstuffed garbage cans. Ugly, half-crumbling brick walls to either side totter oppressively over you. The alley ends here at a tall, wooden fence.

High up on the wall of the northern building there is a narrow, transom-style window.

>enter window
(the window)
The window is too high.

>push cans to window
Grunting and holding your breath, you manhandle one of the filthy cans under the window.

>open window
(the window)
The window is too high.

>enter window
(the window)
(first opening the window)
The window is too high.

* * *

>enter window
(the window)
The window is too high.

>stand on cans
You clamber onto the wobbling garbage can, precariously balanced.

>enter window
(the window)
Hmm. You still can't quite reach, because the garbage can is too far away from the wall. Perhaps if you pushed it closer...

>d
You can only exit the alley to the northwest.

>stand
You get off the cans.

Alley
This narrow aperture between two buildings is nearly blocked with piles of rotting cardboard boxes and overstuffed garbage cans. Ugly, half-crumbling brick walls to either side totter oppressively over you. The alley ends here at a tall, wooden fence.

High up on the wall of the northern building there is a narrow, transom-style window.

I beg your pardon?

>push cans to window
Grunting and holding your breath, you manhandle one of the filthy cans under the window.

* * *

>stand on cans
You clamber onto the wobbling garbage can, precariously balanced. You can just reach the lower edge of the window from here.

>get down
You get off the cans.

Alley
This narrow aperture between two buildings is nearly blocked with piles of rotting cardboard boxes and overstuffed garbage cans. Ugly, half-crumbling brick walls to either side totter oppressively over you. The alley ends here at a tall, wooden fence.

High up on the wall of the northern building there is a narrow, transom-style window. One of the garbage cans has been pushed up against the wall directly underneath it.

>n
The window is too high.

>get on cans
You clamber onto the wobbling garbage can, precariously balanced. You can just reach the lower edge of the window from here.

* * *

>enter window
(the window)
The window is too high.

>rules
Rules tracing now switched on. Type "rules off" to switch it off again, or "rules all" to include even rules which do not apply.

[Rule "parse command rule" applies.]

>enter window
(the window)
[Rule "declare everything initially unmentioned rule" applies.]
[Rule "generate action rule" applies.]
[Rule "announce items from multiple object lists rule" applies.]
[Rule "set pronouns from items from multiple object lists rule" applies.]
[Rule "before stage rule" applies.]
[Rule "basic visibility rule" applies.]
[Rule "basic accessibility rule" applies.]
[Rule "access through barriers rule" applies.]
[Rule "keychain-aware carrying requirements rule" applies.]
[Rule "instead stage rule" applies.]
[Rule "requested actions require persuasion rule" applies.]
[Rule "carry out requested actions rule" applies.]
[Rule "descend to specific action-processing rule" applies.]
[Rule "work out details of specific action rule" applies.]
[Rule "investigate player's awareness before action rule" applies.]
[Rule "player aware of his own actions rule" applies.]
[Rule "check stage rule" applies.]
[Rule "Check entering the window" applies.]
The window is too high.

[Rule "A first turn sequence rule" applies.]
[Rule "scene change machinery rule" applies.]
[Rule "every turn stage rule" applies.]
[Rule "timed events rule" applies.]
[Rule "advance time rule" applies.]
[Rule "update chronological records rule" applies.]
[Rule "A last turn sequence rule" applies.]
[Rule "scene change machinery rule" applies.]
[Rule "adjust light rule" applies.]
[Rule "note object acquisitions rule" applies.]
[Rule "notify score changes rule" applies.]
[Rule "parse command rule" applies.]

>stand on cans
[Rule "declare everything initially unmentioned rule" applies.]
[Rule "generate action rule" applies.]
[Rule "announce items from multiple object lists rule" applies.]
[Rule "set pronouns from items from multiple object lists rule" applies.]
[Rule "before stage rule" applies.]
[Rule "basic visibility rule" applies.]
[Rule "basic accessibility rule" applies.]
[Rule "access through barriers rule" applies.]
[Rule "keychain-aware carrying requirements rule" applies.]
[Rule "instead stage rule" applies.]
[Rule "requested actions require persuasion rule" applies.]
[Rule "carry out requested actions rule" applies.]
[Rule "descend to specific action-processing rule" applies.]
[Rule "work out details of specific action rule" applies.]
[Rule "investigate player's awareness before action rule" applies.]
[Rule "player aware of his own actions rule" applies.]
[Rule "check stage rule" applies.]
[Rule "convert enter door into go rule" applies.]
[Rule "convert enter compass direction into go rule" applies.]
[Rule "can't enter what's already entered rule" applies.]
[Rule "can't enter what's not enterable rule" applies.]
[Rule "can't enter closed containers rule" applies.]
[Rule "can't enter if this exceeds carrying capacity rule" applies.]
[Rule "can't enter something carried rule" applies.]
[Rule "implicitly pass through other barriers rule" applies.]
[Rule "carry out stage rule" applies.]
[Rule "standard entering rule" applies.]
[Rule "after stage rule" applies.]
[Rule "investigate player's awareness after action rule" applies.]
[Rule "report stage rule" applies.]
[Rule "Report entering the cans" applies.]
You clamber onto the wobbling garbage can, precariously balanced. You can just reach the lower edge of the window from here.
[Rule "last specific action-processing rule" applies.]

[Rule "A first turn sequence rule" applies.]
[Rule "scene change machinery rule" applies.]
[Rule "every turn stage rule" applies.]
[Rule "timed events rule" applies.]
[Rule "advance time rule" applies.]
[Rule "update chronological records rule" applies.]
[Rule "A last turn sequence rule" applies.]
[Rule "scene change machinery rule" applies.]
[Rule "adjust light rule" applies.]
[Rule "note object acquisitions rule" applies.]
[Rule "notify score changes rule" applies.]
[Rule "parse command rule" applies.]

* * *

>se
Alley
This narrow aperture between two buildings is nearly blocked with piles of rotting cardboard boxes and overstuffed garbage cans. Ugly, half-crumbling brick walls to either side totter oppressively over you. The alley ends here at a tall, wooden fence.

High up on the wall of the northern building there is a narrow, transom-style window.

>open window
(the window)
The window is too high.

>close window
(the window)
The window is too high.

>search window
(the window)
The window is too high.

>stand on cans
You clamber onto the wobbling garbage can, precariously balanced.

>open window
(the window)
You open the window.

>search window
(the window)
Hmm. You still can't quite reach, because the garbage can is too far away from the wall. Perhaps if you pushed it closer...

>close window
(the window)
You close the window.

>showme cans
cans - supporter
    yourself - person
        clothes (worn)
        trenchcoat (worn) - player's holdall
        wedding ring (worn)
        umbrella
        keyring - keychain
location: in the Alley
unlit, inedible, fixed in place, scenery, seen, familiar; enterable, transparent; singular-named, improper-named; description: "The metal garbage cans are stuffed to overflowing with slowly decomposing refuse."
initial appearance: none
last turn examined: -2
printing: "blank"
carrying capacity: 100
printed name: "cans"
printed plural name: "supporters"
indefinite article: none
list grouping key: none

* * *

>open window
(the window)
The window is too high.

>stand on window
(the window)
The window is too high.

>stand on cans
You clamber onto the wobbling garbage can, precariously balanced.

>open window
(the window)
Hmm. You still can't quite reach, because the garbage can is too far away from the wall. Perhaps if you pushed it closer...

>get down
You get off the cans.

Alley
This narrow aperture between two buildings is nearly blocked with piles of rotting cardboard boxes and overstuffed garbage cans. Ugly, half-crumbling brick walls to either side totter oppressively over you. The alley ends here at a tall, wooden fence.

High up on the wall of the northern building there is a narrow, transom-style window.

>push cans to window
Grunting and holding your breath, you manhandle one of the filthy cans under the window.

* * *

>close window
(the window)
You close the window.

>open window
(the window)
You open the window.

>enter window
(the window)
The window is too high.

* * *

>se
Alley
This narrow aperture between two buildings is nearly blocked with piles of rotting cardboard boxes and overstuffed garbage cans. Ugly, half-crumbling brick walls to either side totter oppressively over you. The alley ends here at a tall, wooden fence.

High up on the wall of the northern building there is a narrow, transom-style window.

>open window. close it. search it. enter it.
(the window)
The window is too high.

The window is too high.

The window is too high.

The window is too high.

>stand on cans
You clamber onto the wobbling garbage can, precariously balanced.

>open window. close it. search it. enter it.
(the window)
Hmm. You still can't quite reach, because the garbage can is too far away from the wall. Perhaps if you pushed it closer...

Hmm. You still can't quite reach, because the garbage can is too far away from the wall. Perhaps if you pushed it closer...

Hmm. You still can't quite reach, because the garbage can is too far away from the wall. Perhaps if you pushed it closer...

Hmm. You still can't quite reach, because the garbage can is too far away from the wall. Perhaps if you pushed it closer...

>d
You can only exit the alley to the northwest.

>go down
You can only exit the alley to the northwest.

>get down
You get off the cans.

Alley
This narrow aperture between two buildings is nearly blocked with piles of rotting cardboard boxes and overstuffed garbage cans. Ugly, half-crumbling brick walls to either side totter oppressively over you. The alley ends here at a tall, wooden fence.

High up on the wall of the northern building there is a narrow, transom-style window.

* * *

>push cans to window
Grunting and holding your breath, you manhandle one of the filthy cans under the window.

>open window. close it. search it. enter it.
(the window)
The window is too high.

The window is too high.

The window is too high.

The window is too high.

>stand on cans
You clamber onto the wobbling garbage can, precariously balanced. You can just reach the lower edge of the window from here.

>open window. close it. search it. enter it.
(the window)
You open the window.

You close the window.

Peering in through the foggy glass, you can see what looks like a file room.

(first opening the window)

File Room
Peering through the murk, you can make out the blocky outlines of filing cabinets lining the walls and a doorway to the west. A window high up on the south wall lets in a very faint illumination.

>open window. close it. search it. enter it.
(the window)
That's already open.

You can hear a fly buzzing around, somewhere in this room.

You close the window.

You can see the damp, dirty alley outside.

You can hear a fly buzzing around, somewhere in the next room.

The window is too high.

* * *

>se
Alley
This narrow aperture between two buildings is nearly blocked with piles of rotting cardboard boxes and overstuffed garbage cans. Ugly, half-crumbling brick walls to either side totter oppressively over you. The alley ends here at a tall, wooden fence.

High up on the wall of the northern building there is a narrow, transom-style window.

>push cans to window
Grunting and holding your breath, you manhandle one of the filthy cans under the window.

* * *

>stand on cans
You clamber onto the wobbling garbage can, precariously balanced. You can just reach the lower edge of the window from here.

>enter window
(the window)
(first opening the window)

File Room
Peering through the murk, you can make out the blocky outlines of filing cabinets lining the walls and a doorway to the west. A window high up on the south wall lets in a very faint illumination.

>enter window
(the window)
The window is too high.

You can hear a fly buzzing around, somewhere in the next room.

>restart
Are you sure you want to restart?

* * *

>y
Informhead
An Interactive Fiction by Ed Peters
Release 1 / Serial number 230615 / Inform 7 v10.1.2 / D

Outside the Real Estate Office
A grim little cul-de-sac, tucked away in a corner of the claustrophobic tangle of narrow, twisting avenues that largely constitute the older portion of Anchorhead. Like most of the streets in this city, it is ancient, shadowy, and leads essentially nowhere. The lane ends here at the real estate agent's office, which lies to the east, and winds its way back toward the center of town to the west. A narrow, garbage-choked alley opens to the southeast.

>se
Alley
This narrow aperture between two buildings is nearly blocked with piles of rotting cardboard boxes and overstuffed garbage cans. Ugly, half-crumbling brick walls to either side totter oppressively over you. The alley ends here at a tall, wooden fence.

High up on the wall of the northern building there is a narrow, transom-style window.

* * *

>open window
(the window)
You open the window.

>enter window
(the window)

File Room
Peering through the murk, you can make out the blocky outlines of filing cabinets lining the walls and a doorway to the west. A window high up on the south wall lets in a very faint illumination.

* * *

>enter window
(the window)
(first opening the window)

File Room
Peering through the murk, you can make out the blocky outlines of filing cabinets lining the walls and a doorway to the west. A window high up on the south wall lets in a very faint illumination.

>l
Alley
This narrow aperture between two buildings is nearly blocked with piles of rotting cardboard boxes and overstuffed garbage cans. Ugly, half-crumbling brick walls to either side totter oppressively over you. The alley ends here at a tall, wooden fence.

High up on the wall of the northern building there is a narrow, transom-style window. One of the garbage cans has been pushed up against the wall directly underneath it.

* * *

>enter window
(the window)
(first getting off the cans)

File Room
Peering through the murk, you can make out the blocky outlines of filing cabinets lining the walls and a doorway to the west. A window high up on the south wall lets in a very faint illumination.

>enter window
(the window)

Alley
This narrow aperture between two buildings is nearly blocked with piles of rotting cardboard boxes and overstuffed garbage cans. Ugly, half-crumbling brick walls to either side totter oppressively over you. The alley ends here at a tall, wooden fence.

High up on the wall of the northern building there is a narrow, transom-style window. One of the garbage cans has been pushed up against the wall directly underneath it.

>stand on cans
You clamber onto the wobbling garbage can, precariously balanced. You can just reach the lower edge of the window from here.

>rules
Rules tracing now switched on. Type "rules off" to switch it off again, or "rules all" to include even rules which do not apply.

[Rule "parse command rule" applies.]

* * *

>i
[Rule "declare everything initially unmentioned rule" applies.]
[Rule "generate action rule" applies.]
[Rule "announce items from multiple object lists rule" applies.]
[Rule "set pronouns from items from multiple object lists rule" applies.]
[Rule "before stage rule" applies.]
[Rule "basic visibility rule" applies.]
[Rule "basic accessibility rule" applies.]
[Rule "keychain-aware carrying requirements rule" applies.]
[Rule "instead stage rule" applies.]
[Rule "Instead of taking inventory" applies.]
You are wearing your clothes, your trenchcoat and your wedding ring.

In addition, you are holding your umbrella and your keyring.

[Rule "A first turn sequence rule" applies.]
[Rule "scene change machinery rule" applies.]
[Rule "every turn stage rule" applies.]
[Rule "Every turn when the player is in File Room or Office Exterior" applies.]
You can hear a fly buzzing around, somewhere in the next room.

[Rule "timed events rule" applies.]
[Rule "advance time rule" applies.]
[Rule "update chronological records rule" applies.]
[Rule "A last turn sequence rule" applies.]
[Rule "scene change machinery rule" applies.]
[Rule "adjust light rule" applies.]
[Rule "note object acquisitions rule" applies.]
[Rule "notify score changes rule" applies.]
[Rule "parse command rule" applies.]

>rules off
[Rule "declare everything initially unmentioned rule" applies.]
[Rule "generate action rule" applies.]
Rules tracing now switched off. Type "rules" to switch it on again.

>l
File Room
Peering through the murk, you can make out the blocky outlines of filing cabinets lining the walls and a doorway to the west. A window high up on the south wall lets in a very faint illumination.

>enter window
(the window)

Alley
This narrow aperture between two buildings is nearly blocked with piles of rotting cardboard boxes and overstuffed garbage cans. Ugly, half-crumbling brick walls to either side totter oppressively over you. The alley ends here at a tall, wooden fence.

High up on the wall of the northern building there is a narrow, transom-style window. One of the garbage cans has been pushed up against the wall directly underneath it.

>n
The window is too high.

>climb window
(the window)
The window is too high.

>climb in
You must name something more substantial.

* * *

>open window. close it. search it. enter it.
(the window)
You open the window.

You close the window.

Peering in through the foggy glass, you can see what looks like a file room.

(first opening the window)

File Room
Peering through the murk, you can make out the blocky outlines of filing cabinets lining the walls and a doorway to the west. A window high up on the south wall lets in a very faint illumination.

>open window. close it. search it. enter it.
(the window)
That's already open.

You close the window.

You can see the damp, dirty alley outside.

(first opening the window)

Alley
This narrow aperture between two buildings is nearly blocked with piles of rotting cardboard boxes and overstuffed garbage cans. Ugly, half-crumbling brick walls to either side totter oppressively over you. The alley ends here at a tall, wooden fence.

High up on the wall of the northern building there is a narrow, transom-style window. One of the garbage cans has been pushed up against the wall directly underneath it.

* * *

>push cans to window
Grunting and holding your breath, you manhandle one of the filthy cans under the window.

>tand on cans
That's not a verb I recognise.

>stand on cans
You clamber onto the wobbling garbage can, precariously balanced. You can just reach the lower edge of the window from here.

* * *

>open window
(the window)
You open the window.

>enter
But you're already on the cans.

>enter window
(the window)

File Room
Peering through the murk, you can make out the blocky outlines of filing cabinets lining the walls and a doorway to the west. A window high up on the south wall lets in a very faint illumination.

>consult cabinet about foo
You don't find anything filed under foo..

You can hear a fly buzzing around, somewhere in the next room.

>consult cabinet about verlac
Bingo!.

[Your score has just gone up by two points.]

* * *

>se
Alley
This narrow aperture between two buildings is nearly blocked with piles of rotting cardboard boxes and overstuffed garbage cans. Ugly, half-crumbling brick walls to either side totter oppressively over you. The alley ends here at a tall, wooden fence.

High up on the wall of the northern building there is a narrow, transom-style window.

>search window
(the window)
The window is too high.

>open window
(the window)
The window is too high.

>enter window
(the window)
The window is too high.

* * *

>stand on cans
You clamber onto the wobbling garbage can, precariously balanced.

>search window
(the window)
Hmm. You still can't quite reach, because the garbage can is too far away from the wall. Perhaps if you pushed it closer...

>open window
(the window)
Hmm. You still can't quite reach, because the garbage can is too far away from the wall. Perhaps if you pushed it closer...

>enter window
(the window)
Hmm. You still can't quite reach, because the garbage can is too far away from the wall. Perhaps if you pushed it closer...

>get down
You get off the cans.

Alley
This narrow aperture between two buildings is nearly blocked with piles of rotting cardboard boxes and overstuffed garbage cans. Ugly, half-crumbling brick walls to either side totter oppressively over you. The alley ends here at a tall, wooden fence.

High up on the wall of the northern building there is a narrow, transom-style window.

* * *

>stand on cans
You clamber onto the wobbling garbage can, precariously balanced. You can just reach the lower edge of the window from here.

>search window
(the window)
Peering in through the foggy glass, you can see what looks like a file room.

>open window
(the window)
You open the window.

* * *

>enter window
(the window)
The window is too high.

>open window
(the window)
The window is too high.

>rules
Rules tracing now switched on. Type "rules off" to switch it off again, or "rules all" to include even rules which do not apply.

[Rule "parse command rule" applies.]

>enter window
(the window)
[Rule "declare everything initially unmentioned rule" applies.]
[Rule "generate action rule" applies.]
[Rule "announce items from multiple object lists rule" applies.]
[Rule "set pronouns from items from multiple object lists rule" applies.]
[Rule "before stage rule" applies.]
[Rule "Before searching or opening or entering the window when the player is not on the cans" applies.]
The window is too high.

[Rule "A first turn sequence rule" applies.]
[Rule "scene change machinery rule" applies.]
[Rule "every turn stage rule" applies.]
[Rule "timed events rule" applies.]
[Rule "advance time rule" applies.]
[Rule "update chronological records rule" applies.]
[Rule "A last turn sequence rule" applies.]
[Rule "scene change machinery rule" applies.]
[Rule "adjust light rule" applies.]
[Rule "note object acquisitions rule" applies.]
[Rule "notify score changes rule" applies.]
[Rule "parse command rule" applies.]

* * *

>search window
(the window)
The window is too high.

>open window. close it. search it.
(the window)
The window is too high.

The window is too high.

The window is too high.

>stand on cans
You clamber onto the wobbling garbage can, precariously balanced.

>open window. close it. search it.
(the window)
You open the window.

You close the window.

Hmm. You still can't quite reach, because the garbage can is too far away from the wall. Perhaps if you pushed it closer...

* * *

>stand on cans
You clamber onto the wobbling garbage can, precariously balanced.

>d
You can only exit the alley to the northwest.

>get down
You get off the cans.

Alley
This narrow aperture between two buildings is nearly blocked with piles of rotting cardboard boxes and overstuffed garbage cans. Ugly, half-crumbling brick walls to either side totter oppressively over you. The alley ends here at a tall, wooden fence.

High up on the wall of the northern building there is a narrow, transom-style window.

* * *

>enter window
(the window)
(first opening the window)

File Room
Peering through the murk, you can make out the blocky outlines of filing cabinets lining the walls and a doorway to the west. A window high up on the south wall lets in a very faint illumination.

>enter window
(the window)
The window is too high.

* * *

>stand on cans
You clamber onto the wobbling garbage can, precariously balanced.

>open window. close it. search it.
(the window)
Hmm. You still can't quite reach, because the garbage can is too far away from the wall. Perhaps if you pushed it closer...

Hmm. You still can't quite reach, because the garbage can is too far away from the wall. Perhaps if you pushed it closer...

Hmm. You still can't quite reach, because the garbage can is too far away from the wall. Perhaps if you pushed it closer...

>get down
You get off the cans.

Alley
This narrow aperture between two buildings is nearly blocked with piles of rotting cardboard boxes and overstuffed garbage cans. Ugly, half-crumbling brick walls to either side totter oppressively over you. The alley ends here at a tall, wooden fence.

High up on the wall of the northern building there is a narrow, transom-style window.

* * *

>stand on cans
You clamber onto the wobbling garbage can, precariously balanced. You can just reach the lower edge of the window from here.

>open window. close it. search it.
(the window)
You open the window.

You close the window.

Peering in through the foggy glass, you can see what looks like a file room.

>enter window
(the window)
(first opening the window)

File Room
Peering through the murk, you can make out the blocky outlines of filing cabinets lining the walls and a doorway to the west. A window high up on the south wall lets in a very faint illumination.

* * *

Informhead
An Interactive Fiction by Ed Peters
Release 1 / Serial number 230628 / Inform 7 v10.1.2 / D

Outside the Real Estate Office
A grim little cul-de-sac, tucked away in a corner of the claustrophobic tangle of narrow, twisting avenues that largely constitute the older portion of Anchorhead. Like most of the streets in this city, it is ancient, shadowy, and leads essentially nowhere. The lane ends here at the real estate agent's office, which lies to the east, and winds its way back toward the center of town to the west. A narrow, garbage-choked alley opens to the southeast.

>se. push cans to window.
Alley
This narrow aperture between two buildings is nearly blocked with piles of rotting cardboard boxes and overstuffed garbage cans. Ugly, half-crumbling brick walls to either side totter oppressively over you. The alley ends here at a tall, wooden fence.

High up on the wall of the northern building there is a narrow, transom-style window. 

Grunting and holding your breath, you manhandle one of the filthy cans under the window.

>stand on cans
You clamber onto the wobbling garbage can, precariously balanced. You can just reach the lower edge of the window from here.

* * *

>open window
(the window)
You open the window.

>enter window
(the window)

File Room
Peering through the murk, you can make out the blocky outlines of filing cabinets lining the walls and a doorway to the west. A window high up on the south wall lets in a very faint illumination.

You can hear a fly buzzing around, somewhere in this room.

>consult cabinet about verlac
Strange; the file on the Verlac property has been cleaned out. Title, deed, all the papers, all of it gone. There is, however, a set of keys tucked down in the hanging folder. You quickly pocket them..

[Your score has just gone up by two points.]

>g
You've already perused that file once..

>g
You've already perused that file once..

* * *

Informhead
An Interactive Fiction by Ed Peters
Release 1 / Serial number 230628 / Inform 7 v10.1.2 / D

Outside the Real Estate Office
A grim little cul-de-sac, tucked away in a corner of the claustrophobic tangle of narrow, twisting avenues that largely constitute the older portion of Anchorhead. Like most of the streets in this city, it is ancient, shadowy, and leads essentially nowhere. The lane ends here at the real estate agent's office, which lies to the east, and winds its way back toward the center of town to the west. A narrow, garbage-choked alley opens to the southeast.

>se. push cans to window. stand on cans.
Alley
This narrow aperture between two buildings is nearly blocked with piles of rotting cardboard boxes and overstuffed garbage cans. Ugly, half-crumbling brick walls to either side totter oppressively over you. The alley ends here at a tall, wooden fence.

High up on the wall of the northern building there is a narrow, transom-style window. 

Grunting and holding your breath, you manhandle one of the filthy cans under the window.

You clamber onto the wobbling garbage can, precariously balanced. You can just reach the lower edge of the window from here.

>open window
(the window)
You open the window.

>enter window
(the window)

File Room
Peering through the murk, you can make out the blocky outlines of filing cabinets lining the walls and a doorway to the west. A window high up on the south wall lets in a very faint illumination.

You can hear a fly buzzing around, somewhere in the next room.

>consult cabinet about verlac
Strange; the file on the Verlac property has been cleaned out. Title, deed, all the papers, all of it gone. There is, however, a set of keys tucked down in the hanging folder. You quickly pocket them.

You can hear a fly buzzing around, somewhere in this room.

[Your score has just gone up by two points.]

* * *

Informhead
An Interactive Fiction by Ed Peters
Release 1 / Serial number 230628 / Inform 7 v10.1.2 / D

Outside the Real Estate Office
A grim little cul-de-sac, tucked away in a corner of the claustrophobic tangle of narrow, twisting avenues that largely constitute the older portion of Anchorhead. Like most of the streets in this city, it is ancient, shadowy, and leads essentially nowhere. The lane ends here at the real estate agent's office, which lies to the east, and winds its way back toward the center of town to the west. A narrow, garbage-choked alley opens to the southeast.

>se. push cans to window. stand on cans. open window. enter window.
Alley
This narrow aperture between two buildings is nearly blocked with piles of rotting cardboard boxes and overstuffed garbage cans. Ugly, half-crumbling brick walls to either side totter oppressively over you. The alley ends here at a tall, wooden fence.

High up on the wall of the northern building there is a narrow, transom-style window. 

Grunting and holding your breath, you manhandle one of the filthy cans under the window.

You clamber onto the wobbling garbage can, precariously balanced. You can just reach the lower edge of the window from here.

(the window)
You open the window.

(the window)

File Room
Peering through the murk, you can make out the blocky outlines of filing cabinets lining the walls and a doorway to the west. A window high up on the south wall lets in a very faint illumination.

>consult cabinet about verlac
Bingo!.

Strange; the file on the Verlac property has been cleaned out. Title, deed, all the papers, all of it gone. There is, however, a set of keys tucked down in the hanging folder. You quickly pocket them.

You can hear a fly buzzing around, somewhere in this room.

[Your score has just gone up by two points.]

* * *

Informhead
An Interactive Fiction by Ed Peters
Release 1 / Serial number 230628 / Inform 7 v10.1.2 / D

Outside the Real Estate Office
A grim little cul-de-sac, tucked away in a corner of the claustrophobic tangle of narrow, twisting avenues that largely constitute the older portion of Anchorhead. Like most of the streets in this city, it is ancient, shadowy, and leads essentially nowhere. The lane ends here at the real estate agent's office, which lies to the east, and winds its way back toward the center of town to the west. A narrow, garbage-choked alley opens to the southeast.

>snap
Entrance to the Paper Mill
The road turns southwest here and runs squarely through the front entrance to the old paper mill. A gate of heavy iron bars blocks the only opening into this charred fortress, although an overgrown path leads around the wall to the south. To the north, a rutted lane threads its way past a row of dilapidated shacks.

>i
You are wearing your clothes, your trenchcoat and your wedding ring.

In addition, you are holding mirror labeled #2, your umbrella and your keyring.

>e
Mill Road
The road carries you across a desolate heath of gray, windswept grass. To the south, the black, jagged outline of Anchorhead's steep roofs and sharp, leaning gables cuts across the horizon. The road forks here to the west and east, heading across the railroad tracks in one direction, out toward the seashore in the other.

A distant flicker of movement draws your eyes eastward to the faraway lighthouse. A lone figure, tiny in the distance, makes its way stealthily around the small spur of rock at the end of the breakwater and slips inside the door at the tower's base. It's impossible to see the person's face from this distance, but the hair, the way he walks... you'd swear it was Michael..

>e
Breakwater
You are picking your way across the breakwater's bare, rocky spine, where the road has diminished to little more than a pair of dusty ruts. A hundred yards to the northeast, at the breakwater's far end, the lonely stone tower of Anchorhead's lighthouse stands vigil against the ocean.

>ne
At the Foot of the Lighthouse
You stand in a circular clearing among the stones, surrounded on nearly every side by the sea. Before you to the east looms the ancient, massive lighthouse, a vertiginous pillar of pale brick jabbing defiantly up at the sky. The road from the southwest ends here, although it looks as though you could pick your way down the rocks to the southeast, around the structure's base.

The great bronze door of the lighthouse stands slightly ajar, revealing a narrow rectangle of blackness within.

>u
In that direction there is only the sea.

>e
Bottom of the Lighthouse
The sound of the ocean is muffled behind the thick cinderblock walls, and the air is damp and heavy. You can almost feel the weight of two hundred feet of hoary old whitewashed brick pressing down on you from above. To the west, a narrow strip of dim light marks the exit. Cracked concrete steps lead up.

>u
Top of the Lighthouse
The stairs give onto a wide, circular chamber surrounded by windows. The glass is old and streaked with grime, but you still have to catch your breath at the magnificence of the view. In one direction, the dying heath and the stunted cluster of buildings that is Anchorhead; in the other, the ocean like a vast, undulating blanket.

Sitting in the middle of the room is what looks like a swivel mount of some kind, although nothing is mounted on it now. Looking up, you see that it rests directly below a large, hexagonal skylight.

>d
Padded Cell
You are in a padded cell, the kind typically reserved for raving lunatics. The room is barely eight feet by eight feet square, with walls and floor of concrete covered with thick, quilted padding. The door in the west wall is also covered with padding, except for a tiny observation window about five feet up, from which a feeble light trickles in.

>i
You are wearing a strait jacket, your clothes and your wedding ring.

>restart
Are you sure you want to restart?

* * *

Informhead
An Interactive Fiction by Ed Peters
Release 1 / Serial number 230628 / Inform 7 v10.1.2 / D

Outside the Real Estate Office
A grim little cul-de-sac, tucked away in a corner of the claustrophobic tangle of narrow, twisting avenues that largely constitute the older portion of Anchorhead. Like most of the streets in this city, it is ancient, shadowy, and leads essentially nowhere. The lane ends here at the real estate agent's office, which lies to the east, and winds its way back toward the center of town to the west. A narrow, garbage-choked alley opens to the southeast.

>test day
>--> The following tests are available:
'test mreads'
'test mfollows'
'test man'
'test muzzle'
'test obs'
'test crypt'
'test 1a'
'test 1b'
'test 1c'
'test 1d'
'test 1e'
'test 1f'
'test day1'
'test 2a'
'test 2b'
'test 2c'
'test 2d'
'test 2e'
'test 2f'
'test 2g'
'test 2h'
'test 2i'
'test 2j'
'test 2k'
'test 2l'
'test day2'
'test 3a'
'test 3b'
'test 3c'
'test 3d'
'test 3e'
'test 3f'
'test 3g'
'test 3h'
'test 3i'
'test 3j'
'test 3k'
'test 3l'
'test 3m'
'test 3n'
'test 3o'
'test 3p'
'test 3q'
'test 3r'
'test day3'

* * *

>i
You are wearing your clothes and your wedding ring.

The pockets of your trenchcoat contain an old rusty meat hook, a flashlight, a gold locket, a small copper key, a puzzle box, a strange metal flute, a silver locket, Michael's faculty card, an old tin, a lantern and your umbrella.

>restart
Are you sure you want to restart?

* * *

>s
Town Square
A wide expanse of uneven pavestones lies open to the sky, bordered on all sides by the leaning, steep-roofed architecture that looms over everything in this city. The municipal courthouse stands at the south end of the square, next to the mouth of a dark, narrow alley to the southwest. Avenues to the west and east lead back into the cramped and ingrown streets, while to the north lies Whateley Bridge.

In the center of the square, rising from a circular lawn of unhealthy-looking grass and weeds, stands a strange, stone obelisk. It seems to be a monument of some sort, although you can see no plaque or marker anywhere near it.

Michael looks at you and smiles. It is not a particularly pleasant smile. He walks over to the obelisk and places his hand against the bloodstained stone, then mutters something guttural under his breath. The twisted hieroglyphs begin to shine with an eerie phosphorescence which quickly brightens and envelopes Michael. His form wavers, then becomes transparent, and when the light fades he has disappeared..

The obelisk is still glowing brightly.

>touch obelisk
As your fingers touch the gore-streaked stone, the green light grows brighter, fanning out to envelope you. The odor of rotting fruit briefly assails your nostrils; your vision streaks, then blurs; there is the sound of rushing air, and when your eyes clear, you are somewhere else...

Burial Mound
The cave is lined, floor to ceiling, with mummified human corpses. Shrunken and desiccated, they lie in jumbled heaps inside irregularly carved niches. Carvings cover the rock walls in between the niches -- grotesque, leering faces too horrible even to look upon, their features twitching and smirking in the wavering light that sifts down from above.

And dominating the center of the chamber: a dark monolith rising up through the green, murky light -- what you first took to be a large, supporting pillar, you now realize can only be the true base of the town square obelisk.

At the narrower, northern end of the vaguely egg-shaped cavern sits a massive stone altar, flanked on either side by a pair of strange, vibrating columns.

Michael -- or rather, the thing that has possessed Michael's body -- is standing here.

Suddenly Michael lunges forward and grabs your arms. He shakes you, causing your head to whip back and forth and your teeth to click painfully together.

"Bitch -- " he hisses, " -- rotten, filthy bitch -- you never give up, do you? You've foiled me for the last time! There's no way to fix what you've undone tonight, but by all the unholy spawn of darkness I will put you in a stone cold place for it!!" And his hands lock tightly around your throat and begin to squeeze.

>rules
Rules tracing now switched on. Type "rules off" to switch it off again, or "rules all" to include even rules which do not apply.

[Rule "parse command rule" applies.]

>show ring to michael
[Rule "declare everything initially unmentioned rule" applies.]
[Rule "generate action rule" applies.]
[Rule "announce items from multiple object lists rule" applies.]
[Rule "set pronouns from items from multiple object lists rule" applies.]
[Rule "before stage rule" applies.]
[Rule "basic visibility rule" applies.]
[Rule "basic accessibility rule" applies.]
[Rule "access through barriers rule" applies.]
[Rule "keychain-aware carrying requirements rule" applies.]
[Rule "instead stage rule" applies.]
[Rule "Instead of showing the wedding ring to Michael when Michael Flees is happening for the first time" applies.]
There is one chance -- if you can only somehow reach whatever weak flicker of humanity still survives within that shell; if the person who was your husband still exists somewhere, buried beneath the part that is Croseus Verlac...

Silently, you raise up your left hand, your wedding ring gleaming softly in the strange, green light.

Michael is transfixed. He seems to want to recoil from the sight, yet is somehow simultaneously drawn to it. Suddenly, his face crumbles, the madness and stoic evil falling away to reveal confusion, fear, vulnerability and anguish -- all superimposed upon the malevolent features of Croseus, struggling to regain control.

*** Run-time problem P21: Attempt to look up a non-existent correspondence in the table 'Table of Accomplishments'.

[Rule "A first turn sequence rule" applies.]
[Rule "scene change machinery rule" applies.]
[Rule "every turn stage rule" applies.]
[Rule "Every turn during Michael Flees" applies.]
[Rule "timed events rule" applies.]
[Rule "advance time rule" applies.]
[Rule "update chronological records rule" applies.]
[Rule "A last turn sequence rule" applies.]
[Rule "scene change machinery rule" applies.]
[Rule "adjust light rule" applies.]
[Rule "note object acquisitions rule" applies.]
[Rule "notify score changes rule" applies.]
[Your score has just gone up by two points.]

[Rule "parse command rule" applies.]

* * *

>save
Ok.

>test 2a
(Testing.)

>[1] stand
You get off the bed.

Master Bedroom
The master bedroom is a picture-postcard of rustic New England charm. Faded sketches of rural landscapes adorn the walls; a beautifully carved dressing mirror stands in one corner; an old-fashioned accordion radiator gurgles quietly beneath the window. The most striking feature, an enormous, antique, four-poster bed, must be the largest piece of furniture in the house.

On the four-poster bed you can see Michael's pants.

You can also see your trenchcoat (empty), your clothes, your keyring (on which are a cellar key and a house key), your umbrella, a flask, a lantern and an old tin (closed) here.

>[2] dress
(taking your clothes)
(taking your trenchcoat)
You slip on your clothes and your trenchcoat.

>[3] take all
keyring: Taken.
umbrella: Taken.
flask: Taken.
lantern: No one here looks as though they'd mind if you borrowed one of these lamps. Casually, you purloin the nearest one.
old tin: Taken.

>[4] look in pants
In Michael's pants is Michael's wallet.

>[5] look in wallet
In Michael's wallet is Michael's faculty card.

>[6] take card
(putting the keyring into the trenchcoat to make room)
You slip the keyring into the pocket of your trenchcoat.

Taken.

The shower suddenly stops. Quickly you palm the card, replace the wallet and arrange the pants the way you found them. A moment later Michael emerges from the bathroom, toweling his hair. "My, don't you look tempting this morning," he says, giving you a kiss. He tosses the towel back into the bathroom and gets dressed. "I think I'm going to stay home and get some writing done. I don't actually start work until tomorrow, so..." He kisses you on the cheek as he walks out into the hall. "If you go out today, see if you can find a newspaper. I want to learn as much as I can about this town."

He looks at you for a moment, and his voice becomes serious. "I love you, hon. You know that, don't you? I really want us to try and be happy here."

Then he turns and pads down the hall.

You take a deep breath as he goes. You've never lied to Michael or hidden anything from him before, ever; now, hardly two days into your new life, you're already sneaking through his wallet.

Oh yeah. You're off to a great start.

* * *

>test 2a
(Testing.)

>[1] stand
You get off the bed.

Master Bedroom
The master bedroom is a picture-postcard of rustic New England charm. Faded sketches of rural landscapes adorn the walls; a beautifully carved dressing mirror stands in one corner; an old-fashioned accordion radiator gurgles quietly beneath the window. The most striking feature, an enormous, antique, four-poster bed, must be the largest piece of furniture in the house.

On the four-poster bed you can see Michael's pants.

You can also see your trenchcoat (empty), your clothes, your keyring (on which are a cellar key and a house key), your umbrella, a flask, a lantern and an old tin (closed) here.

>[2] dress
(taking your clothes)
(taking your trenchcoat)
You slip on your clothes and your trenchcoat.

>[3] take all
keyring: Taken.
umbrella: Taken.
flask: Taken.
lantern: No one here looks as though they'd mind if you borrowed one of these lamps. Casually, you purloin the nearest one.
old tin: Taken.

>[4] look in pants
In Michael's pants is Michael's wallet.

>[5] look in wallet
In Michael's wallet is Michael's faculty card.

>[6] take card
(putting the keyring into the trenchcoat to make room)
You slip the keyring into the pocket of your trenchcoat.

Taken.

The shower suddenly stops. Quickly you palm the card, replace the wallet and arrange the pants the way you found them. A moment later Michael emerges from the bathroom, toweling his hair. "My, don't you look tempting this morning," he says, giving you a kiss. He tosses the towel back into the bathroom and gets dressed. "I think I'm going to stay home and get some writing done. I don't actually start work until tomorrow, so..." He kisses you on the cheek as he walks out into the hall. "If you go out today, see if you can find a newspaper. I want to learn as much as I can about this town."

He looks at you for a moment, and his voice becomes serious. "I love you, hon. You know that, don't you? I really want us to try and be happy here."

Then he turns and pads down the hall.

You take a deep breath as he goes. You've never lied to Michael or hidden anything from him before, ever; now, hardly two days into your new life, you're already sneaking through his wallet.

Oh yeah. You're off to a great start.

* * *

>i
You are wearing your trenchcoat, your clothes and your wedding ring.

In addition, you are holding a silver locket, Michael's faculty card, an old tin, a lantern and a flask.

The pockets of your trenchcoat contain your umbrella and your keyring.

Your keyring contains a cellar key and a house key (which opens the front door).

>test 2c
(Testing.)

>[1] w

Upstairs Landing
A narrow hallway runs east, from the top of the stairs down the length of the house. To the north, directly opposite the stairs, is the master bedroom.

>[2] d

Foyer
Although it appears spacious from the outside, the house's interior feels cramped and gloomy. The walls seem too close together; the ceiling is too high. The doorways, leading in several directions, are narrow and filled with shadows, and the stairs leading up to the second floor are steep and rickety. This is not a house that makes you feel welcome. It is a house that makes you feel tiny and timid, and afraid of dark places. It is a house that makes you feel alone.

Your luggage is still here, spread out all over the foyer.

>[3] w

Dining Room
Much of the elegance has faded from this room. The huge dining table running the length of it is covered with a thick gray film of dust, and the china cupboard standing against the far wall is draped in shadow. Doorways to the north and east offer little relief from the gloom. For what must be the hundredth time, you wish you could open the windows in this place.

It's a free-standing cabinet about as tall as you are, crafted of cherrywood. The double paneled doors are closed.

>[4] open cupboard
The cupboard is empty; the china must have been auctioned off, in the confusion before Michael was contacted, perhaps. Down at the bottom of the cupboard is a velvet lining, where the silverware would usually be kept.

>[5] pull lining
You pull the lining back a bit further and discover a thin, palm-sized journal tucked underneath it. Intrigued, you pull the little book free.

[Your score has just gone up by two points.]

>[6] read journal
It's a slim little book, no bigger than your hand, bound in imitation leather. The mice really have been at it; most of the pages have been chewed away. What's left of the journal reads:

Desperate. Went back to the old twisting lane and found only a blank wall. Without the amulet, how can I resist --

...bottles, bottles...

Getting worse. People I have never met smile knowingly at me in the street. The police believe I am a child molester, but have brought no charges against me as yet. Why? Head hurts all the time. I have turned the cellar upside-down... damn it all, where is it?

Dreamed of Father again. Dreamed of Grandfather. Those horrible, red-rimmed eyes...

 -- into the safe, finally. 22-2-46. Won't forget THAT soon. Ha!

CANNOT DISCOVER ENTRANCE IN THE CELLAR!!! Secret eludes me still but I WILL FIND IT!!! The clue is in their names, that pestilential procession of names! If I could only -- 

The text breaks off as several more pages are missing. the last fragmented entry reads:

 -- will fail. There is no recourse left. I know now what I must do. Julia -- 

>[7] drop journal
Dropped.

* * *

>i
You are wearing your trenchcoat, your clothes and your wedding ring.

In addition, you are holding an animal's skull, an old-fashioned iron key (which opens the crypt door), your keyring, a flashlight and a silver locket.

The pockets of your trenchcoat contain Michael's faculty card, an old tin, a lantern, a flask and your umbrella.

Your keyring contains a cellar key (which opens the cdoor) and a house key (which opens the front door and the back door).

* * *

>test 2g
(Testing.)

>[1] e
You can't go that way.

>[2] s
You can't go that way.

>[3] unlock door
You can't see any such thing.

>[4] s
You can't go that way.

>[5] se
You can't go that way.

>[6] ne
You can't go that way.

>[7] n
The old man waves as you leave. "Come back soon," he calls.

Hidden Court
You had no idea this little courtyard even existed, cleverly tucked away amidst the confusing tangle of darker avenues. Although surrounded on all sides by steep rooftops and overshadowed by the ever- ominous clouds, this secluded circle somehow manages to convey a sense of peace and brightness, a safe harbor from the oppressive gloom pervading the rest of the town. To the south, a hanging sign marks a humble shop, while a sidestreet to the east leads back into the labyrinth.

>[8] w
You can't go that way.

>[9] n
You can't go that way.

>[10] n
You can't go that way.

>[11] nw
You can't go that way.

>[12] x graffiti
You can't see any such thing.

>[13] w
You can't go that way.

>[14] s
A silvery bell jingles as you open the door.

Cauldron
A warm and pleasantly dim light surrounds you and suffuses this cozy little shop. The shelves are crammed with every conceivable variety of new age curiosity: books, crystals, pendants, charms, herbs, potions, incense, candles and -- sure enough, on a display stand right near the door -- decorative cast-iron cauldron-shaped paperweights. How cute. In the rear of the store, a lit display case contains several items of interest. The courtyard lies outside, to the north.

On the display case is a violin.

The proprietor watches you quietly from behind the display case.

>[15] give puzzle box to man
You can't see any such thing.

>[16] ask man about amulet
"We've already discussed that now, haven't we?" He winks slyly at you.

* * *

>test 2k
(Testing.)

>[1] put newspaper under door
You slide the newspaper under the door, leaving only an inch or two sticking out on your side.

>[2] put opener in keyhole
The tip of the letter opener bumps against something, and you hear something thump onto the newspaper on the other side of the door.

>[3] take newspaper
Something metallic falls off the newspaper as you pull it out from under the door.

>[4] take key
(the old-fashioned brass key)
You slide the old-fashioned brass key on to your keyring.

(putting the old-fashioned iron key into the trenchcoat to make room)
You slip the old-fashioned iron key into the pocket of your trenchcoat.

Taken.

>i
You are wearing your trenchcoat, your clothes and your wedding ring.

In addition, you are holding an old-fashioned brass key, a newspaper, a letter opener, a small copper key and a flashlight.

The pockets of your trenchcoat contain an old-fashioned iron key (which opens the crypt door), your keyring, a silver locket, Michael's faculty card, an old tin, a lantern and your umbrella.

Your keyring contains a cellar key (which opens the cdoor) and a house key (which opens the front door and the back door).

>test 2l
(Testing.)

>[1] unlock door
(with the old-fashioned brass key)
You unlock the attic door.

>[2] n
(first opening the attic door)

Attic Cell
A cramped little annex off the main attic, with a tiny, shuttered window high up on the north wall. A pile of mouldering straw in the corner and what looks like pencil marks on the lower part of the walls seem to indicate that someone lived here once. Or, possibly, was kept here.

>[3] search straw
You gingerly poke through the filthy straw, barely able to suppress your disgust. However, your search is not unrewarded: underneath the thickest part of the pile, you discover a tiny gold locket.

>[4] take locket
(the gold locket)
(putting the small copper key into the trenchcoat to make room)
You slip the small copper key into the pocket of your trenchcoat.

Taken.

>[5] s

Attic
It's much cooler up here than in the rest of the house, and you find it hard to suppress a shiver. Grotesque, looming shadows crawl across the low, slanted ceiling, and the dust hangs thick and motionless in the air. To the west the ceiling dips even lower until the space beneath leaves hardly room enough to crawl, while to the north stands a wooden door, draped in shadows and half-hidden by the slanting eaves.

A rickety wooden ladder descends to the hallway below.

>[6] drop newspaper
Dropped.

>[7] drop opener
Dropped.

>[8] d

Upstairs Hall
The shuttered window at the end of the hall throws a gloomy rectangle of light onto the bare wooden floor. Doorways lead north and south.

A rickety wooden ladder stands here, descending from a three-foot by three-foot square of darkness in the ceiling.

>i
You are wearing your trenchcoat, your clothes and your wedding ring.

In addition, you are holding a gold locket, an old-fashioned brass key (which opens the attic door) and a flashlight.

The pockets of your trenchcoat contain a small copper key, an old-fashioned iron key (which opens the crypt door), your keyring, a silver locket, Michael's faculty card, an old tin, a lantern and your umbrella.

Your keyring contains a cellar key (which opens the cdoor) and a house key (which opens the front door and the back door).

>put iron key on keyring
(first taking the old-fashioned iron key)
You put the old-fashioned iron key on the keyring.

>put copper key on keyring
(first taking the small copper key)
You put the small copper key on the keyring.

>i
You are wearing your trenchcoat, your clothes and your wedding ring.

In addition, you are holding a gold locket, an old-fashioned brass key (which opens the attic door) and a flashlight.

The pockets of your trenchcoat contain your keyring, a silver locket, Michael's faculty card, an old tin, a lantern and your umbrella.

Your keyring contains a small copper key, an old-fashioned iron key (which opens the crypt door), a cellar key (which opens the cdoor) and a house key (which opens the front door and the back door).

>restore
Restore failed.

* * *

>restart
Are you sure you want to restart?

>y
Informhead
An Interactive Fiction by Ed Peters
Release 1 / Serial number 230614 / Inform 7 v10.1.2 / D

Outside the Real Estate Office
A grim little cul-de-sac, tucked away in a corner of the claustrophobic tangle of narrow, twisting avenues that largely constitute the older portion of Anchorhead. Like most of the streets in this city, it is ancient, shadowy, and leads essentially nowhere. The lane ends here at the real estate agent's office, which lies to the east, and winds its way back toward the center of town to the west. A narrow, garbage-choked alley opens to the southeast.

>test day2
>--> The following tests are available:
'test mreads'
'test mfollows'
'test man'
'test nastymist'
'test goodmist'
'test notice'
'test muzzle'
'test obs'
'test crypt'
'test 1a'
'test 1b'
'test 1c'
'test 1d'
'test 1e'
'test 1f'
'test day1'
'test 2a'
'test 2b'
'test 2c'
'test 2d'
'test 2e'
'test 2f'
'test 2g'
'test 2h'
'test 2i'
'test 2j'
'test 2k'
'test 2l'
'test day2a'
'test day2b'
'test 3a'
'test 3b'
'test 3c'
'test 3d'
'test 3e'

* * *

>d
You can't go that way.

>s
Upstairs Landing
A narrow hallway runs east, from the top of the stairs down the length of the house. To the north, directly opposite the stairs, is the master bedroom.

* * *

>take light
(putting the umbrella into the trenchcoat to make room)
You slip the umbrella into the pocket of your trenchcoat.

Taken.

>nw
Darkness
It is pitch dark, and you can't see a thing.

>turn on light
You switch the flashlight on.

Pantry
The pantry is empty save for a layer of dust on the shelves. A door to the south leads down to the cellar, or you can return to the kitchen to the southeast.

Leaning in the corner is an old broom.

>d
(first opening the cdoor)
(first unlocking the cdoor)
(first taking the keyring)
(putting the flask into the trenchcoat to make room)
You slip the flask into the pocket of your trenchcoat.

(with the cellar key)

Cellar
The old, flagstone walls gleam with unwholesome-smelling moisture, and the sagging timbers creak uneasily above your head. Ancient, frayed wiring festoons the ceiling like some strange species of clinging vine. Portions of the cellar extend south and east into the clammy darkness, though you could always beat a hasty retreat up the stairs to the north.

One largish bundle of wires leads down to a rusty old fuse cabinet bolted to the far wall.

>s
Storage Room
Old crates and boxes piled high against the walls make this room seem even smaller and dingier than it actually is, which is saying a lot. A doorway lies north; the other walls contain nothing but shadows and dirt-filled corners.

* * *

>search crates
You spend some time poking dispiritedly through boxes of second-hand table settings, discarded shoes and outdated encyclopedias, but the only thing you manage to dig up is an old cardboard box full of newspaper clippings, which might make interesting reading later if you can find the time. The only thing at all noteworthy about the room, in fact, is that it desperately wants cleaning; there's even a big, nasty-looking spider web in a corner behind one of the crates.

>clean web
You gingerly stick your hand into the tangled spider web, and something light and skittery crawls across your skin and bites you!

Quickly you jerk back, compulsively wiping your hand on your pants. The bite itself didn't hurt all that much, but the thought of spiders crawling around on your skin gives you the willies.

>n
Cellar
The old, flagstone walls gleam with unwholesome-smelling moisture, and the sagging timbers creak uneasily above your head. Ancient, frayed wiring festoons the ceiling like some strange species of clinging vine. Portions of the cellar extend south and east into the clammy darkness, though you could always beat a hasty retreat up the stairs to the north.

One largish bundle of wires leads down to a rusty old fuse cabinet bolted to the far wall.

* * *

>u
Pantry
The pantry is empty save for a layer of dust on the shelves. A door to the south leads down to the cellar, or you can return to the kitchen to the southeast.

Leaning in the corner is an old broom.

>se
Kitchen
Where once pots and skillets and various utensils hung in profusion, the kitchen walls are now merely ranks of dusty cabinets and a forest of empty hooks. Doorways lead east and south, a small pantry lies to the northwest, and the back door to the north leads out of the house.

A wave of dizziness washes over you suddenly, making you light-headed. Your hand is swollen and throbbing a little, and your skin is flushed with an unpleasant, prickly heat. It occurs to you to wonder whether the spider that bit you might have been poisonous.

>e
Back Hall
A short hallway, connecting rooms to the east, west and south.

>s
Foyer
Although it appears spacious from the outside, the house's interior feels cramped and gloomy. The walls seem too close together; the ceiling is too high. The doorways, leading in several directions, are narrow and filled with shadows, and the stairs leading up to the second floor are steep and rickety. This is not a house that makes you feel welcome. It is a house that makes you feel tiny and timid, and afraid of dark places. It is a house that makes you feel alone.

Your luggage is still here, spread out all over the foyer.

The dizziness hits you again, and you sway as little black ink blots bloom in your vision. Your hand is really hurting now, and you feel short of breath.

>e
Sitting Room
The east wall is occupied by a beautiful antique sofa, and a large, hand-woven rug covers the hardwood floor. The huge marble fireplace in the north wall helps complete the impression of comfort and warmth, and for a moment or two you can almost think of this place as somewhere you could live, as opposed to merely somewhere others have died. The foyer lies west, and a doorway to the left of the fireplace leads north.

Your brief sense of comfort quickly drains away, however, as you become aware of the icy and maniacal stare emanating from the great portrait hanging over the mantelpiece. Under the malefic gaze of those red-rimmed eyes, the most comforting thought you can muster is that of immediate flight.

On the sofa is a family album.

>w
Foyer
Although it appears spacious from the outside, the house's interior feels cramped and gloomy. The walls seem too close together; the ceiling is too high. The doorways, leading in several directions, are narrow and filled with shadows, and the stairs leading up to the second floor are steep and rickety. This is not a house that makes you feel welcome. It is a house that makes you feel tiny and timid, and afraid of dark places. It is a house that makes you feel alone.

Your luggage is still here, spread out all over the foyer.

You are burning up; you can barely see through the waves of blackness washing across your vision. You try to sit down, only to realize that you're already lying on the ground, unable to move. In a disconnected, feverish haze, you vaguely wonder if Michael will find you in time to call the hospital; and that is your last thought before feeling leaves your limbs and your lungs stop working entirely.

    *** You have died. ***

In that game you scored 4 out of a possible 0, in 78 turns.

Would you like to RESTART, RESTORE a saved game, QUIT or UNDO the last command?

>restart
Informhead
An Interactive Fiction by Ed Peters
Release 1 / Serial number 230614 / Inform 7 v10.1.2 / D

Outside the Real Estate Office
A grim little cul-de-sac, tucked away in a corner of the claustrophobic tangle of narrow, twisting avenues that largely constitute the older portion of Anchorhead. Like most of the streets in this city, it is ancient, shadowy, and leads essentially nowhere. The lane ends here at the real estate agent's office, which lies to the east, and winds its way back toward the center of town to the west. A narrow, garbage-choked alley opens to the southeast.

* * *

>test day2
>--> The following tests are available:
'test mreads'
'test mfollows'
'test man'
'test nastymist'
'test goodmist'
'test notice'
'test muzzle'
'test obs'
'test crypt'
'test 1a'
'test 1b'
'test 1c'
'test 1d'
'test 1e'
'test 1f'
'test day1'
'test 2a'
'test 2b'
'test 2c'
'test 2d'
'test 2e'
'test 2f'
'test 2g'
'test 2h'
'test 2i'
'test 2j'
'test 2k'
'test 2l'
'test day2a'
'test day2b'
'test 3a'
'test 3b'
'test 3c'
'test 3d'
'test 3e'

>day2atest
That's not a verb I recognise.

* * *

>i
You are wearing your trenchcoat, your clothes and your wedding ring.

In addition, you are holding a silver locket, a puzzle box, an old-fashioned iron key (which opens the crypt door) and a flashlight.

The pockets of your trenchcoat contain your keyring, a strange metal flute, Michael's faculty card, an old tin, a lantern and your umbrella.

Your keyring contains a cellar key (which opens the cdoor) and a house key (which opens the front door and the back door).

>restore
Restore failed.

* * *

>i
You are wearing your trenchcoat, your clothes and your wedding ring.

In addition, you are holding an old-fashioned iron key, your keyring, a flashlight and a strange metal flute.

The pockets of your trenchcoat contain a puzzle box, a silver locket, Michael's faculty card, an old tin, a lantern, a flask and your umbrella.

Your keyring contains a cellar key (which opens the cdoor) and a house key (which opens the front door).

>restore
Restore failed.

* * *

>i
You are wearing your trenchcoat, your clothes and your wedding ring.

In addition, you are holding a silver locket, Michael's faculty card, an old tin, a lantern and a flask.

The pockets of your trenchcoat contain your umbrella and your keyring.

Your keyring contains a cellar key and a house key (which opens the front door).

>test 2c
(Testing.)

>[1] w

Upstairs Landing
A narrow hallway runs east, from the top of the stairs down the length of the house. To the north, directly opposite the stairs, is the master bedroom.

>[2] d

Foyer
Although it appears spacious from the outside, the house's interior feels cramped and gloomy. The walls seem too close together; the ceiling is too high. The doorways, leading in several directions, are narrow and filled with shadows, and the stairs leading up to the second floor are steep and rickety. This is not a house that makes you feel welcome. It is a house that makes you feel tiny and timid, and afraid of dark places. It is a house that makes you feel alone.

Your luggage is still here, spread out all over the foyer.

>[3] w

Dining Room
Much of the elegance has faded from this room. The huge dining table running the length of it is covered with a thick gray film of dust, and the china cupboard standing against the far wall is draped in shadow. Doorways to the north and east offer little relief from the gloom. For what must be the hundredth time, you wish you could open the windows in this place.

It's a free-standing cabinet about as tall as you are, crafted of cherrywood. The double paneled doors are closed.

>[4] open cupboard
The cupboard is empty; the china must have been auctioned off, in the confusion before Michael was contacted, perhaps. Down at the bottom of the cupboard is a velvet lining, where the silverware would usually be kept.

>[5] pull lining
You pull the lining back a bit further and discover a thin, palm-sized journal tucked underneath it. Intrigued, you pull the little book free.

[Your score has just gone up by two points.]

>[6] read journal
It's a slim little book, no bigger than your hand, bound in imitation leather. The mice really have been at it; most of the pages have been chewed away. What's left of the journal reads:

Desperate. Went back to the old twisting lane and found only a blank wall. Without the amulet, how can I resist --

...bottles, bottles...

Getting worse. People I have never met smile knowingly at me in the street. The police believe I am a child molester, but have brought no charges against me as yet. Why? Head hurts all the time. I have turned the cellar upside-down... damn it all, where is it?

Dreamed of Father again. Dreamed of Grandfather. Those horrible, red-rimmed eyes...

 -- into the safe, finally. 7-2-42. Won't forget THAT soon. Ha!

CANNOT DISCOVER ENTRANCE IN THE CELLAR!!! Secret eludes me still but I WILL FIND IT!!! The clue is in their names, that pestilential procession of names! If I could only -- 

The text breaks off as several more pages are missing. the last fragmented entry reads:

 -- will fail. There is no recourse left. I know now what I must do. Julia -- 

>[7] drop journal
Dropped.

* * *

>n
Back Hall
A short hallway, connecting rooms to the east, west and south.

* * *

>take light. turn it on. nw. take broom. unlock door. d.
(putting the old tin into the trenchcoat to make room)
You slip the old tin into the pocket of your trenchcoat.

Taken.

I only understood you as far as wanting to turn the flashlight.

>turn it on
You switch the flashlight on.

>d.
You can't go that way.

>nw. take broom. unlock door.
Pantry
The pantry is empty save for a layer of dust on the shelves. A door to the south leads down to the cellar, or you can return to the kitchen to the southeast.

Leaning in the corner is an old broom.

(putting Michael's faculty card into the trenchcoat to make room)
You slip Michael's faculty card into the pocket of your trenchcoat.

Taken.

(first taking the keyring)
(putting the silver locket into the trenchcoat to make room)
You slip the silver locket into the pocket of your trenchcoat.

(with the cellar key)
You unlock the cdoor.

>d
(first opening the cdoor)

Cellar
The old, flagstone walls gleam with unwholesome-smelling moisture, and the sagging timbers creak uneasily above your head. Ancient, frayed wiring festoons the ceiling like some strange species of clinging vine. Portions of the cellar extend south and east into the clammy darkness, though you could always beat a hasty retreat up the stairs to the north.

One largish bundle of wires leads down to a rusty old fuse cabinet bolted to the far wall.

>i
You are wearing your trenchcoat, your clothes and your wedding ring.

In addition, you are holding your keyring, a broom, a flashlight, a strange metal flute and a puzzle box.

The pockets of your trenchcoat contain a silver locket, Michael's faculty card, an old tin, a lantern, a flask and your umbrella.

Your keyring contains a cellar key (which opens the cdoor) and a house key (which opens the front door).

>s
Storage Room
Old crates and boxes piled high against the walls make this room seem even smaller and dingier than it actually is, which is saying a lot. A doorway lies north; the other walls contain nothing but shadows and dirt-filled corners.

* * *

>search crates
You spend some time poking dispiritedly through boxes of second-hand table settings, discarded shoes and outdated encyclopedias, but the only thing you manage to dig up is an old cardboard box full of newspaper clippings, which might make interesting reading later if you can find the time. The only thing at all noteworthy about the room, in fact, is that it desperately wants cleaning; there's even a big, nasty-looking spider web in a corner behind one of the crates.

>clean web with broom
With a single sweep of the broom, you clear the spider web away.

* * *

>l
Storage Room
Old crates and boxes piled high against the walls make this room seem even smaller and dingier than it actually is, which is saying a lot. A doorway lies north; the other walls contain nothing but shadows and dirt-filled corners.

You can see an old-fashioned iron key and a cardboard box (in which are some newspaper clippings) here.

>take key
(the old-fashioned iron key)
You slide the old-fashioned iron key on to your keyring.

(putting the puzzle box into the trenchcoat to make room)
You slip the puzzle box into the pocket of your trenchcoat.

[Your score has just gone up by one point.]

>i
You are wearing your trenchcoat, your clothes and your wedding ring.

In addition, you are holding an old-fashioned iron key, your keyring, a broom, a flashlight and a strange metal flute.

The pockets of your trenchcoat contain a puzzle box, a silver locket, Michael's faculty card, an old tin, a lantern, a flask and your umbrella.

Your keyring contains a cellar key (which opens the cdoor) and a house key (which opens the front door).

>drop iron key
Dropped.

>take iron key
Taken.

>showme iron key
old-fashioned iron key - passkey
location: carried by yourself in the Storage Room
unlit, inedible, portable, handled, seen, familiar; singular-named, improper-named
description: "It's an old key, the kind with a round barrel about a quarter-inch in diameter and flat, square teeth."
initial appearance: none
last turn examined: -2
printing: "blank"
printed name: "old-fashioned iron key"
printed plural name: "passkeys"
indefinite article: none
list grouping key: none

>restart
Are you sure you want to restart?

* * *

>test 2c
(Testing.)

>[1] w

Upstairs Landing
A narrow hallway runs east, from the top of the stairs down the length of the house. To the north, directly opposite the stairs, is the master bedroom.

>[2] d

Foyer
Although it appears spacious from the outside, the house's interior feels cramped and gloomy. The walls seem too close together; the ceiling is too high. The doorways, leading in several directions, are narrow and filled with shadows, and the stairs leading up to the second floor are steep and rickety. This is not a house that makes you feel welcome. It is a house that makes you feel tiny and timid, and afraid of dark places. It is a house that makes you feel alone.

Your luggage is still here, spread out all over the foyer.

>[3] w

Dining Room
Much of the elegance has faded from this room. The huge dining table running the length of it is covered with a thick gray film of dust, and the china cupboard standing against the far wall is draped in shadow. Doorways to the north and east offer little relief from the gloom. For what must be the hundredth time, you wish you could open the windows in this place.

It's a free-standing cabinet about as tall as you are, crafted of cherrywood. The double paneled doors are closed.

>[4] open cupboard
The cupboard is empty; the china must have been auctioned off, in the confusion before Michael was contacted, perhaps. Down at the bottom of the cupboard is a velvet lining, where the silverware would usually be kept.

>[5] pull lining
You pull the lining back a bit further and discover a thin, palm-sized journal tucked underneath it. Intrigued, you pull the little book free.

[Your score has just gone up by two points.]

>[6] read journal
It's a slim little book, no bigger than your hand, bound in imitation leather. The mice really have been at it; most of the pages have been chewed away. What's left of the journal reads:

Desperate. Went back to the old twisting lane and found only a blank wall. Without the amulet, how can I resist --

...bottles, bottles...

Getting worse. People I have never met smile knowingly at me in the street. The police believe I am a child molester, but have brought no charges against me as yet. Why? Head hurts all the time. I have turned the cellar upside-down... damn it all, where is it?

Dreamed of Father again. Dreamed of Grandfather. Those horrible, red-rimmed eyes...

 -- into the safe, finally. 41-18-20. Won't forget THAT soon. Ha!

CANNOT DISCOVER ENTRANCE IN THE CELLAR!!! Secret eludes me still but I WILL FIND IT!!! The clue is in their names, that pestilential procession of names! If I could only -- 

The text breaks off as several more pages are missing. the last fragmented entry reads:

 -- will fail. There is no recourse left. I know now what I must do. Julia -- 

>[7] drop journal
Dropped.

>n
Kitchen
Where once pots and skillets and various utensils hung in profusion, the kitchen walls are now merely ranks of dusty cabinets and a forest of empty hooks. Doorways lead east and south, a small pantry lies to the northwest, and the back door to the north leads out of the house.

An odd feeling of gloom overtakes you momentarily, and you find yourself thinking about the Verlac family's personal effects -- the everyday mundanities, such as kitchen utensils. Were they thrown out, or donated to charity, or auctioned off as grisly souvenirs? What about the canned goods? Did anyone think to take them? The cabinets might even still be stocked. Morbidly, you wonder what Mrs. Edward Verlac might have been cooking for dinner the night her husband blew her head off.

Someone's flashlight is lying on the kitchen counter; one of the movers must have left it.

>take light. turn it on.
(putting the flask into the trenchcoat to make room)
You slip the flask into the pocket of your trenchcoat.

Taken.

I only understood you as far as wanting to turn the flashlight.

>turn it on
You switch the flashlight on.

>put all in pockets
flashlight: You slip the flashlight into the pocket of your trenchcoat.
silver locket: You slip the silver locket into the pocket of your trenchcoat.
Michael's faculty card: You slip Michael's faculty card into the pocket of your trenchcoat.
old tin: You slip the old tin into the pocket of your trenchcoat.
lantern: You slip the lantern into the pocket of your trenchcoat.

>nw
Pantry
The pantry is empty save for a layer of dust on the shelves. A door to the south leads down to the cellar, or you can return to the kitchen to the southeast.

Leaning in the corner is an old broom.

>take broom
Taken.

>unlock door
(first taking the keyring)
(with the cellar key)
You unlock the cdoor.

>d
(first opening the cdoor)

Cellar
The old, flagstone walls gleam with unwholesome-smelling moisture, and the sagging timbers creak uneasily above your head. Ancient, frayed wiring festoons the ceiling like some strange species of clinging vine. Portions of the cellar extend south and east into the clammy darkness, though you could always beat a hasty retreat up the stairs to the north.

One largish bundle of wires leads down to a rusty old fuse cabinet bolted to the far wall.

>i
You are wearing your trenchcoat, your clothes and your wedding ring.

In addition, you are holding your keyring and a broom.

The pockets of your trenchcoat contain a lantern, an old tin, Michael's faculty card, a silver locket, a flashlight, a flask and your umbrella.

Your keyring contains a cellar key (which opens the cdoor) and a house key (which opens the front door).

>s
Storage Room
Old crates and boxes piled high against the walls make this room seem even smaller and dingier than it actually is, which is saying a lot. A doorway lies north; the other walls contain nothing but shadows and dirt-filled corners.

* * *

>clean web with broom
With a single sweep of the broom, you clear the spider web away.

>i
You are wearing your trenchcoat, your clothes and your wedding ring.

In addition, you are holding your keyring and a broom.

The pockets of your trenchcoat contain a lantern, an old tin, Michael's faculty card, a silver locket, a flashlight, a flask and your umbrella.

Your keyring contains a cellar key (which opens the cdoor) and a house key (which opens the front door).

>take key
(the old-fashioned iron key)
You slide the old-fashioned iron key on to your keyring.

[Your score has just gone up by one point.]

>i
You are wearing your trenchcoat, your clothes and your wedding ring.

In addition, you are holding an old-fashioned iron key, your keyring and a broom.

The pockets of your trenchcoat contain a lantern, an old tin, Michael's faculty card, a silver locket, a flashlight, a flask and your umbrella.

Your keyring contains a cellar key (which opens the cdoor) and a house key (which opens the front door).

* * *

>n
Library
Whatever else their faults may have been, the Verlacs were evidently not ones to shun the printed word. Books line the walls from floor to ceiling in this dark-paneled, green-carpeted room, interrupted only by doorways to the east and south. A rich, brown leather armchair sits in stately repose near the window, with a polished brass pipe stand nearby completing the picture of some blue-blooded country squire's literary refuge. Once again, you are struck by how easily this place could have been the perfect home.

A beautiful pair of mahogany sliding doors stand closed to the east.

Resting on the pipe stand is a sizable volume decorated with a gilded pentagram on its cover.

>showme safe
safe - closed container
    dial (part of safe)
    puzzle box - closed container
        strange black disk
    strange metal flute
        first hole (part of strange metal flute) - fhole
        second hole (part of strange metal flute) - fhole
        third hole (part of strange metal flute) - fhole
        fourth hole (part of strange metal flute) - fhole
        fifth hole (part of strange metal flute) - fhole
        sixth hole (part of strange metal flute) - fhole
location: out of play
unlit, inedible, fixed in place, scenery, unseen, unfamiliar; opaque, closed, unopenable, unlocked; singular-named, improper-named
description: "It's a stark cube of black, oily steel, fifteen inches to a side. Its only feature is large calibrated dial set into the front."
initial appearance: "A section of the shelves in the western wall has slid to one side, revealing a hidden safe."
last turn examined: -2
printing: "blank"
carrying capacity: 100
printed name: "safe"
printed plural name: "containers"
indefinite article: none
list grouping key: none
true combination: 32, 37 and 4
current combination: 
stage: 0
c3: 0
c2: 0
c1: 0

>l
Library
Whatever else their faults may have been, the Verlacs were evidently not ones to shun the printed word. Books line the walls from floor to ceiling in this dark-paneled, green-carpeted room, interrupted only by doorways to the east and south. A rich, brown leather armchair sits in stately repose near the window, with a polished brass pipe stand nearby completing the picture of some blue-blooded country squire's literary refuge. Once again, you are struck by how easily this place could have been the perfect home.

A beautiful pair of mahogany sliding doors stand closed to the east.

Resting on the pipe stand is a sizable volume decorated with a gilded pentagram on its cover.

* * *

>test 2c
(Testing.)

>[1] w

Upstairs Landing
A narrow hallway runs east, from the top of the stairs down the length of the house. To the north, directly opposite the stairs, is the master bedroom.

>[2] d

Foyer
Although it appears spacious from the outside, the house's interior feels cramped and gloomy. The walls seem too close together; the ceiling is too high. The doorways, leading in several directions, are narrow and filled with shadows, and the stairs leading up to the second floor are steep and rickety. This is not a house that makes you feel welcome. It is a house that makes you feel tiny and timid, and afraid of dark places. It is a house that makes you feel alone.

Your luggage is still here, spread out all over the foyer.

>[3] w

Dining Room
Much of the elegance has faded from this room. The huge dining table running the length of it is covered with a thick gray film of dust, and the china cupboard standing against the far wall is draped in shadow. Doorways to the north and east offer little relief from the gloom. For what must be the hundredth time, you wish you could open the windows in this place.

It's a free-standing cabinet about as tall as you are, crafted of cherrywood. The double paneled doors are closed.

>[4] open cupboard
The cupboard is empty; the china must have been auctioned off, in the confusion before Michael was contacted, perhaps. Down at the bottom of the cupboard is a velvet lining, where the silverware would usually be kept.

>[5] pull lining
You pull the lining back a bit further and discover a thin, palm-sized journal tucked underneath it. Intrigued, you pull the little book free.

[Your score has just gone up by two points.]

>[6] read journal
It's a slim little book, no bigger than your hand, bound in imitation leather. The mice really have been at it; most of the pages have been chewed away. What's left of the journal reads:

Desperate. Went back to the old twisting lane and found only a blank wall. Without the amulet, how can I resist --

...bottles, bottles...

Getting worse. People I have never met smile knowingly at me in the street. The police believe I am a child molester, but have brought no charges against me as yet. Why? Head hurts all the time. I have turned the cellar upside-down... damn it all, where is it?

Dreamed of Father again. Dreamed of Grandfather. Those horrible, red-rimmed eyes...

 -- into the safe, finally. 47-42-24. Won't forget THAT soon. Ha!

CANNOT DISCOVER ENTRANCE IN THE CELLAR!!! Secret eludes me still but I WILL FIND IT!!! The clue is in their names, that pestilential procession of names! If I could only -- 

The text breaks off as several more pages are missing. the last fragmented entry reads:

 -- will fail. There is no recourse left. I know now what I must do. Julia -- 

>[7] drop journal
Dropped.

>n
Kitchen
Where once pots and skillets and various utensils hung in profusion, the kitchen walls are now merely ranks of dusty cabinets and a forest of empty hooks. Doorways lead east and south, a small pantry lies to the northwest, and the back door to the north leads out of the house.

An odd feeling of gloom overtakes you momentarily, and you find yourself thinking about the Verlac family's personal effects -- the everyday mundanities, such as kitchen utensils. Were they thrown out, or donated to charity, or auctioned off as grisly souvenirs? What about the canned goods? Did anyone think to take them? The cabinets might even still be stocked. Morbidly, you wonder what Mrs. Edward Verlac might have been cooking for dinner the night her husband blew her head off.

Someone's flashlight is lying on the kitchen counter; one of the movers must have left it.

>take light.
(putting the flask into the trenchcoat to make room)
You slip the flask into the pocket of your trenchcoat.

Taken.

>turn it on.
I only understood you as far as wanting to turn the flashlight.

>turn on light.
You switch the flashlight on.

>nw
Pantry
The pantry is empty save for a layer of dust on the shelves. A door to the south leads down to the cellar, or you can return to the kitchen to the southeast.

Leaning in the corner is an old broom.

>unlock door. take broom.
(first taking the keyring)
(putting the lantern into the trenchcoat to make room)
You slip the lantern into the pocket of your trenchcoat.

(with the cellar key)
You unlock the cellar door.

(putting the old tin into the trenchcoat to make room)
You slip the old tin into the pocket of your trenchcoat.

Taken.

>d
(first opening the cellar door)

Cellar
The old, flagstone walls gleam with unwholesome-smelling moisture, and the sagging timbers creak uneasily above your head. Ancient, frayed wiring festoons the ceiling like some strange species of clinging vine. Portions of the cellar extend south and east into the clammy darkness, though you could always beat a hasty retreat up the stairs to the north.

One largish bundle of wires leads down to a rusty old fuse cabinet bolted to the far wall.

>s
Storage Room
Old crates and boxes piled high against the walls make this room seem even smaller and dingier than it actually is, which is saying a lot. A doorway lies north; the other walls contain nothing but shadows and dirt-filled corners.

>sweep web with broom
You can't see any such thing.

>search crates
You spend some time poking dispiritedly through boxes of second-hand table settings, discarded shoes and outdated encyclopedias, but the only thing you manage to dig up is an old cardboard box full of newspaper clippings, which might make interesting reading later if you can find the time. The only thing at all noteworthy about the room, in fact, is that it desperately wants cleaning; there's even a big, nasty-looking spider web in a corner behind one of the crates.

>sweep web with broom
With a single sweep of the broom, you clear the spider web away.

>i
You are wearing your trenchcoat, your clothes and your wedding ring.

In addition, you are holding a broom, your keyring, a flashlight, a silver locket and Michael's faculty card.

The pockets of your trenchcoat contain an old tin, a lantern, a flask and your umbrella.

Your keyring contains a cellar key (which opens the cellar door) and a house key (which opens the front door).

>showme iron key
old-fashioned iron key - passkey
location: in the Storage Room
unlit, inedible, portable, unseen, unfamiliar; singular-named, improper-named
description: "It's an old key, the kind with a round barrel about a quarter-inch in diameter and flat, square teeth."
initial appearance: none
last turn examined: -2
printing: "blank"
printed name: "old-fashioned iron key"
printed plural name: "passkeys"
indefinite article: none
list grouping key: none

>i
You are wearing your trenchcoat, your clothes and your wedding ring.

In addition, you are holding a broom, your keyring, a flashlight, a silver locket and Michael's faculty card.

The pockets of your trenchcoat contain an old tin, a lantern, a flask and your umbrella.

Your keyring contains a cellar key (which opens the cellar door) and a house key (which opens the front door).

>put locket and card in pockets
silver locket: You slip the silver locket into the pocket of your trenchcoat.
Michael's faculty card: You slip Michael's faculty card into the pocket of your trenchcoat.

>i
You are wearing your trenchcoat, your clothes and your wedding ring.

In addition, you are holding a broom, your keyring and a flashlight.

The pockets of your trenchcoat contain Michael's faculty card, a silver locket, an old tin, a lantern, a flask and your umbrella.

Your keyring contains a cellar key (which opens the cellar door) and a house key (which opens the front door).

>l
Storage Room
Old crates and boxes piled high against the walls make this room seem even smaller and dingier than it actually is, which is saying a lot. A doorway lies north; the other walls contain nothing but shadows and dirt-filled corners.

You can see an old-fashioned iron key and a cardboard box (in which are some newspaper clippings) here.

>take iron key
You slide the old-fashioned iron key on to your keyring.
handling the noun ...
moving the noun ...

[Your score has just gone up by one point.]

>i
You are wearing your trenchcoat, your clothes and your wedding ring.

In addition, you are holding an old-fashioned iron key, a broom, your keyring and a flashlight.

The pockets of your trenchcoat contain Michael's faculty card, a silver locket, an old tin, a lantern, a flask and your umbrella.

Your keyring contains a cellar key (which opens the cellar door) and a house key (which opens the front door).

* * *

>stand
You get off the bed.

Master Bedroom
The master bedroom is a picture-postcard of rustic New England charm. Faded sketches of rural landscapes adorn the walls; a beautifully carved dressing mirror stands in one corner; an old-fashioned accordion radiator gurgles quietly beneath the window. The most striking feature, an enormous, antique, four-poster bed, must be the largest piece of furniture in the house.

On the bed is Michael.

You can also see your clothes, your trenchcoat (in which are a small copper key, a puzzle box (in which is a strange black disk), a strange metal flute, a silver locket, a towel, Michael's faculty card, an old tin (closed), a lantern and your umbrella), a flashlight, your keyring (on which are an old-fashioned brass key, an old-fashioned iron key, a cellar key and a house key) and a gold locket here.

>dress
You try to get dressed as quietly as possible, but apparently Michael isn't as knocked out as you thought he was.

Michael comes awake with a jerk and a hoarse shout. For a moment or two he only stares about blindly, as if unsure of where he is and all but unaware of your presence. Then, with a grunt of surprise, he seems to come to his senses and painstakingly crawls out of bed.

(taking your clothes)
(taking your trenchcoat)
You slip on your clothes and your trenchcoat.

Michael wanders off to the west, looking around aimlessly, as though searching for something without even knowing what it is that is lost.

>s
Upstairs Landing
A narrow hallway runs east, from the top of the stairs down the length of the house. To the north, directly opposite the stairs, is the master bedroom.

* * *

>d
Foyer
Although it appears spacious from the outside, the house's interior feels cramped and gloomy. The walls seem too close together; the ceiling is too high. The doorways, leading in several directions, are narrow and filled with shadows, and the stairs leading up to the second floor are steep and rickety. This is not a house that makes you feel welcome. It is a house that makes you feel tiny and timid, and afraid of dark places. It is a house that makes you feel alone.

Your luggage is still here, spread out all over the foyer.

>s
Suddenly you hear a deep grinding noise that seems to vibrate up through the floor from beneath the house. A moment later there is a terrible, wailing howl as of some subterranean wind shrieking through unlit passages. Then the grinding again, and all is silent.

Timidly, you call out Michael's name. There is no answer. You are alone in the house.

(first opening the front door)
The hairs on the back of your neck prickle as you step outside. Something is wrong. Something is very wrong with the air. A heavy, charged sensation, like standing next to high-tension wires; a faint odor of spoiled meat drifting on the wind; you can't put your finger on it, but it might have something to do with that strange hole in the sky.

Outside the House
The lane runs up from the southeast and ends at a wide clearing surrounded by gnarled and ancient trees. A wide, curving driveway runs up to the front door of your house, which lies north.

The Verlac mansion looms before you, casting an air of menace ove the clearing.

A typewritten notice has been attached to the front door.

>gonear file cabinet
File Room
Peering through the murk, you can make out the blocky outlines of filing cabinets lining the walls and a doorway to the west. A window high up on the south wall lets in a very faint illumination.

>w
Office
Pallid gray light trickles in through the drawn blinds. The office is deserted, papers still scattered across the top of the desk. The front door lies west, and the file room lies east.

Sitting on the corner of the paper-strewn desk are a telephone and an answering machine.

The office door is open.

Someone seems to have left a cup of coffee sitting out, half-finished and cold.

>w
Outside the Real Estate Office
A grim little cul-de-sac, tucked away in a corner of the claustrophobic tangle of narrow, twisting avenues that largely constitute the older portion of Anchorhead. Like most of the streets in this city, it is ancient, shadowy, and leads essentially nowhere. The lane ends here at the real estate agent's office, which lies to the east, and winds its way back toward the center of town to the west. A narrow, garbage-choked alley opens to the southeast.

The office door is open.

>w
Narrow Street
As the lane winds along from east to west, it narrows until the steep, jagged rooftops on either side of the street practically touch each other. To the south, a side street leads across Whateley Bridge toward the center of town, and a twisting lane leads up a hill to the northwest. A short flight of steps to the north leads down to the local watering hole.

>nw
Strange; the graffiti is gone now. Not a trace of it left.

Twisting Lane
The lane narrows here to little more than a badly cobbled sidewalk as it wends its way up through a series of tortuous bends and switchbacks. In some places, the street is so steep that steps have been cut into it, worn down over the years and slick with moss. Your progress is blocked at the top of the street by a blank brick wall.

* * *

>scenes
Scene 'Entire Game' playing (for 188 mins now)
Scene 'Day 1' ended
Scene 'Michael Reads' ended
Scene 'Michael Follows' ended
Scene 'Michael Sleeps' ended
Scene 'Day 2' ended
Scene 'Michael Showers' ended
Scene 'Michael Writes' ended
Scene 'Close of Day' playing (for 38 mins now)
Scene 'Day 3' playing (for 3 mins now)
Scene 'Michael Sleeps Again' ended
Scene 'Michael Wanders' playing (for 1 mins now)
(Scene monitoring now switched on. Type "scenes off" to switch it off again.)

>d
You can't go that way.

Michael walks a few steps across the room and then stops, as if he had forgotten what he had gone there to do..

>s
Upstairs Landing
A narrow hallway runs east, from the top of the stairs down the length of the house. To the north, directly opposite the stairs, is the master bedroom.

Michael wanders in. He seems surprised, as if he didn't expect to see you here.

>d
Foyer
Although it appears spacious from the outside, the house's interior feels cramped and gloomy. The walls seem too close together; the ceiling is too high. The doorways, leading in several directions, are narrow and filled with shadows, and the stairs leading up to the second floor are steep and rickety. This is not a house that makes you feel welcome. It is a house that makes you feel tiny and timid, and afraid of dark places. It is a house that makes you feel alone.

Your luggage is still here, spread out all over the foyer.

Michael wanders in. He seems surprised, as if he didn't expect to see you here.

>scenes
Scene 'Entire Game' playing (for 191 mins now)
Scene 'Day 1' ended
Scene 'Michael Reads' ended
Scene 'Michael Follows' ended
Scene 'Michael Sleeps' ended
Scene 'Day 2' ended
Scene 'Michael Showers' ended
Scene 'Michael Writes' ended
Scene 'Close of Day' playing (for 41 mins now)
Scene 'Day 3' playing (for 6 mins now)
Scene 'Michael Sleeps Again' ended
Scene 'Michael Wanders' playing (for 4 mins now)
(Scene monitoring now switched on. Type "scenes off" to switch it off again.)

>s
Suddenly you hear a deep grinding noise that seems to vibrate up through the floor from beneath the house. A moment later there is a terrible, wailing howl as of some subterranean wind shrieking through unlit passages. Then the grinding again, and all is silent.

Timidly, you call out Michael's name. There is no answer. You are alone in the house.

(first opening the front door)

Outside the House
The lane runs up from the southeast and ends at a wide clearing surrounded by gnarled and ancient trees. A wide, curving driveway runs up to the front door of your house, which lies north.

The Verlac mansion looms before you, casting an air of menace ove the clearing.

A typewritten notice has been attached to the front door.

[Scene 'Michael Wanders' ends]
[Scene 'Out on the Town' begins]

* * *

>stand. dress.
You get off the bed.

Master Bedroom
The master bedroom is a picture-postcard of rustic New England charm. Faded sketches of rural landscapes adorn the walls; a beautifully carved dressing mirror stands in one corner; an old-fashioned accordion radiator gurgles quietly beneath the window. The most striking feature, an enormous, antique, four-poster bed, must be the largest piece of furniture in the house.

On the bed is Michael.

You can also see your clothes, your trenchcoat (in which are a small copper key, a puzzle box (in which is a strange black disk), a strange metal flute, a silver locket, a towel, Michael's faculty card, an old tin (closed), a lantern and your umbrella), a flashlight, your keyring (on which are an old-fashioned brass key, an old-fashioned iron key, a cellar key and a house key) and a gold locket here.

You try to get dressed as quietly as possible, but apparently Michael isn't as knocked out as you thought he was.

Michael comes awake with a jerk and a hoarse shout. For a moment or two he only stares about blindly, as if unsure of where he is and all but unaware of your presence. Then, with a grunt of surprise, he seems to come to his senses and painstakingly crawls out of bed.

(taking your clothes)
(taking your trenchcoat)
You slip on your clothes and your trenchcoat.

Michael wanders off to the west, absently rubbing his forehead.

>s
Upstairs Landing
A narrow hallway runs east, from the top of the stairs down the length of the house. To the north, directly opposite the stairs, is the master bedroom.

>d
Foyer
Although it appears spacious from the outside, the house's interior feels cramped and gloomy. The walls seem too close together; the ceiling is too high. The doorways, leading in several directions, are narrow and filled with shadows, and the stairs leading up to the second floor are steep and rickety. This is not a house that makes you feel welcome. It is a house that makes you feel tiny and timid, and afraid of dark places. It is a house that makes you feel alone.

Your luggage is still here, spread out all over the foyer.

You can hear Michael moving around elsewhere in the house, the floorboards creaking uneasily with his footsteps.

>s
Suddenly you hear a deep grinding noise that seems to vibrate up through the floor from beneath the house. A moment later there is a terrible, wailing howl as of some subterranean wind shrieking through unlit passages. Then the grinding again, and all is silent.

Timidly, you call out Michael's name. There is no answer. You are alone in the house.

(first opening the front door)

Outside the House
The lane runs up from the southeast and ends at a wide clearing surrounded by gnarled and ancient trees. A wide, curving driveway runs up to the front door of your house, which lies north.

The Verlac mansion looms before you, casting an air of menace ove the clearing.

A typewritten notice has been attached to the front door.

>scenes
Scene 'Entire Game' playing (for 191 mins now)
Scene 'Day 1' ended
Scene 'Michael Reads' ended
Scene 'Michael Follows' ended
Scene 'Michael Sleeps' ended
Scene 'Day 2' ended
Scene 'Michael Showers' ended
Scene 'Michael Writes' ended
Scene 'Close of Day' playing (for 41 mins now)
Scene 'Day 3' playing (for 6 mins now)
Scene 'Michael Sleeps Again' ended
Scene 'Michael Wanders' ended
Scene 'Out on the Town' playing (for 1 mins now)
(Scene monitoring now switched on. Type "scenes off" to switch it off again.)

* * *

>stand. dress. s. d.
You get off the bed.

Master Bedroom
The master bedroom is a picture-postcard of rustic New England charm. Faded sketches of rural landscapes adorn the walls; a beautifully carved dressing mirror stands in one corner; an old-fashioned accordion radiator gurgles quietly beneath the window. The most striking feature, an enormous, antique, four-poster bed, must be the largest piece of furniture in the house.

On the bed is Michael.

You can also see your clothes, your trenchcoat (in which are a small copper key, a puzzle box (in which is a strange black disk), a strange metal flute, a silver locket, a towel, Michael's faculty card, an old tin (closed), a lantern and your umbrella), a flashlight, your keyring (on which are an old-fashioned brass key, an old-fashioned iron key, a cellar key and a house key) and a gold locket here.

You try to get dressed as quietly as possible, but apparently Michael isn't as knocked out as you thought he was.

Michael comes awake with a jerk and a hoarse shout. For a moment or two he only stares about blindly, as if unsure of where he is and all but unaware of your presence. Then, with a grunt of surprise, he seems to come to his senses and painstakingly crawls out of bed.

(taking your clothes)
(taking your trenchcoat)
You slip on your clothes and your trenchcoat.

A shiver runs up your back, for no apparent reason; turning, you realize that Michael has been staring at you. He looks away, his expression unreadable..

Upstairs Landing
A narrow hallway runs east, from the top of the stairs down the length of the house. To the north, directly opposite the stairs, is the master bedroom.

Michael wanders in. He seems surprised, as if he didn't expect to see you here.

Foyer
Although it appears spacious from the outside, the house's interior feels cramped and gloomy. The walls seem too close together; the ceiling is too high. The doorways, leading in several directions, are narrow and filled with shadows, and the stairs leading up to the second floor are steep and rickety. This is not a house that makes you feel welcome. It is a house that makes you feel tiny and timid, and afraid of dark places. It is a house that makes you feel alone.

Your luggage is still here, spread out all over the foyer.

>s
Suddenly you hear a deep grinding noise that seems to vibrate up through the floor from beneath the house. A moment later there is a terrible, wailing howl as of some subterranean wind shrieking through unlit passages. Then the grinding again, and all is silent.

Timidly, you call out Michael's name. There is no answer. You are alone in the house.

(first opening the front door)

Outside the House
The lane runs up from the southeast and ends at a wide clearing surrounded by gnarled and ancient trees. A wide, curving driveway runs up to the front door of your house, which lies north.

The Verlac mansion looms before you, casting an air of menace over the clearing.

The hairs on the back of your neck prickle as you step outside. Something is wrong. Something is very wrong with the air. A heavy, charged sensation, like standing next to high-tension wires; a faint odor of spoiled meat drifting on the wind; you can't put your finger on it, but it might have something to do with that strange hole in the sky.

A typewritten notice has been attached to the front door.

>l
Outside the House
The lane runs up from the southeast and ends at a wide clearing surrounded by gnarled and ancient trees. A wide, curving driveway runs up to the front door of your house, which lies north.

The Verlac mansion looms before you, casting an air of menace ove the clearing.

A typewritten notice has been attached to the front door.

>x sky
You can't see any such thing.

>gonear file cabinet
File Room
Peering through the murk, you can make out the blocky outlines of filing cabinets lining the walls and a doorway to the west. A window high up on the south wall lets in a very faint illumination.

* * *

>w
Outside the Real Estate Office
A grim little cul-de-sac, tucked away in a corner of the claustrophobic tangle of narrow, twisting avenues that largely constitute the older portion of Anchorhead. Like most of the streets in this city, it is ancient, shadowy, and leads essentially nowhere. The lane ends here at the real estate agent's office, which lies to the east, and winds its way back toward the center of town to the west. A narrow, garbage-choked alley opens to the southeast.

The office door is open.

>x sky
You can't see any such thing.

>x cobblestones
You can't see any such thing.

>w
Narrow Street
As the lane winds along from east to west, it narrows until the steep, jagged rooftops on either side of the street practically touch each other. To the south, a side street leads across Whateley Bridge toward the center of town, and a twisting lane leads up a hill to the northwest. A short flight of steps to the north leads down to the local watering hole.

>nw
Strange; the graffiti is gone now. Not a trace of it left.

* * *

>tesr foo
That's not a verb I recognise.

* * *

>n
There's not much in that direction except the featureless, desolate heath.

>ne
There's not much in that direction except the featureless, desolate heath.

>e
Breakwater
You are picking your way across the breakwater's bare, rocky spine, where the road has diminished to little more than a pair of dusty ruts. A hundred yards to the northeast, at the breakwater's far end, the lonely stone tower of Anchorhead's lighthouse stands vigil against the ocean.

>ne
At the Foot of the Lighthouse
You stand in a circular clearing among the stones, surrounded on nearly every side by the sea. Before you looms the ancient, massive lighthouse, a vertiginous pillar of pale brick jabbing defiantly up at the sky. The road from the southwest ends here, although it looks as though you could pick your way down the rocks to the southeast, around the structure's base.

>x door
A monstrous slab of solid bronze set into the thick stone wall of the lighthouse base. Age and seawater have covered its once gleaming surface with an unhealthy green crust of verdigris.

>open door
(first unlocking the great bronze door)
(with the tarnished bronze key)
With great effort, you manage to pull the ancient, creaking door open a few inches, enough to slip through.

>e
Bottom of the Lighthouse
The sound of the ocean is muffled behind the thick cinderblock walls, and the air is damp and heavy. You can almost feel the weight of two hundred feet of hoary old whitewashed brick pressing down on you from above. To the west, a narrow strip of dim light marks the exit. Cracked concrete steps lead up.

* * *

>d
Padded Cell
You are in a padded cell, the kind typically reserved for raving lunatics. The room is barely eight feet by eight feet square, with walls and floor of concrete covered with thick, quilted padding. The door in the west wall is also covered with padding, except for a tiny observation window about five feet up, from which a feeble light trickles in.

>i
You are wearing your clothes and your wedding ring.

The pockets of your trenchcoat contain an old rusty meat hook, a flashlight, a gold locket, a small copper key, a puzzle box, a strange metal flute, a silver locket, Michael's faculty card, an old tin, a lantern and your umbrella.

>scenes
Scene 'Entire Game' playing (for 326 mins now)
Scene 'Day 1' ended
Scene 'Michael Reads' ended
Scene 'Michael Follows' ended
Scene 'Michael Sleeps' ended
Scene 'Day 2' ended
Scene 'Michael Showers' ended
Scene 'Michael Writes' ended
Scene 'Close of Day' playing (for 176 mins now)
Scene 'Day 3' ended
Scene 'Michael Sleeps Again' ended
Scene 'Michael Wanders' ended
Scene 'Out on the Town' playing (for 125 mins now)
Scene 'Good Will Hunting' ended
Scene 'Folks on the Road' ended
Scene 'Folks on the Bridge' playing (for 85 mins now)
Scene 'Michael Snaps' ended
Scene 'Day 4' playing (for 2 mins now)
Scene 'Loony Binned' playing (for 2 mins now)
(Scene monitoring now switched on. Type "scenes off" to switch it off again.)

* * *

>test 3m
(Testing.)

>[1] w
There appears to be a commotion of sorts to the south, where a group of townsfolk have gathered.

Narrow Street
As the lane winds along from east to west, it narrows until the steep, jagged rooftops on either side of the street practically touch each other. To the south, a side street leads across Whateley Bridge toward the center of town, and a twisting lane leads up a hill to the northwest. A short flight of steps to the north leads down to the local watering hole.

There appears to be a commotion of sorts to the south, where a group of townsfolk have gathered.

>[2] x commotion
The townsfolk have gathered in a small crowd on Whateley Bridge. Word of your snooping must have gotten around quickly; these fellows are obviously not taking any chances on the possibility of you escaping from the church, and are keeping a sharp lookout.

>[3] nw

Twisting Lane
The lane narrows here to little more than a badly cobbled sidewalk as it wends its way up through a series of tortuous bends and switchbacks. In some places, the street is so steep that steps have been cut into it, worn down over the years and slick with moss. Your progress is blocked at the top of the street by a blankbrick wall.

>scenes
Scene 'Entire Game' playing (for 277 mins now)
Scene 'Day 1' ended
Scene 'Michael Reads' ended
Scene 'Michael Follows' ended
Scene 'Michael Sleeps' ended
Scene 'Day 2' ended
Scene 'Michael Showers' ended
Scene 'Michael Writes' ended
Scene 'Close of Day' playing (for 130 mins now)
Scene 'Day 3' playing (for 95 mins now)
Scene 'Michael Sleeps Again' ended
Scene 'Michael Wanders' ended
Scene 'Out on the Town' playing (for 79 mins now)
Scene 'Good Will Hunting' ended
Scene 'Folks on the Road' ended
Scene 'Folks on the Bridge' playing (for 39 mins now)
(Scene monitoring now switched on. Type "scenes off" to switch it off again.)

* * *

>e
Breakwater
You are picking your way across the breakwater's bare, rocky spine, where the road has diminished to little more than a pair of dusty ruts. A hundred yards to the northeast, at the breakwater's far end, the lonely stone tower of Anchorhead's lighthouse stands vigil against the ocean.

* * *

>ne
At the Foot of the Lighthouse
You stand in a circular clearing among the stones, surrounded on nearly every side by the sea. Before you looms the ancient, massive lighthouse, a vertiginous pillar of pale brick jabbing defiantly up at the sky. The road from the southwest ends here, although it looks as though you could pick your way down the rocks to the southeast, around the structure's base.

>e
Bottom of the Lighthouse
The sound of the ocean is muffled behind the thick cinderblock walls, and the air is damp and heavy. You can almost feel the weight of two hundred feet of hoary old whitewashed brick pressing down on you from above. To the west, a narrow strip of dim light marks the exit. Cracked concrete steps lead up.

* * *

>test 3p
(Testing.)

>[1] u

Workshop
Several workbenches and racks of arcane electronic equipment have been dragged together to form a sort of open laboratory on this wide balcony overlooking the mill. A wide table dominates the area, strewn with precision tools, bits of wire, and scribbled calculations. To the south, a narrow catwalk hangs above the mill floor, and a metal ladder leads down into the machinery below.

On the workbenches are some notes and some arcane electronic equipment.

One of the racks contains a number of circular mirrors, stacked side by side like dishes in a dishwasher.

Prominent among the strange tools scattered across the table is a strange caliper-like instrument.

Tacked up on the wall is a large technical blueprint.

>[2] x blueprint
The blueprint is a technical schematic for some extremely complicated device, the exact purpose of which is anything but clear. It looks a bit like a telescope, a bit like a microwave oven turned inside out, and a bit like the "industrial laser" from Goldfinger. The inner workings of the device involve a complicated arrangement of lenses and mirrors and a hopeless tangle of circuitry that vaguely resembles several dozen street maps of Manhattan laid across each other. Some of the notations on the circuitry don't even look like technical symbols; they look more like cabbalistic runes.

Next to what must represent the main focusing mirror of the device, someone has written the number "0.0113"; someone else, in another handwriting, has scratched that number out and written below it, "0.0182".

>[3] take calipers
Taken.

>[4] measure mirror 2
(with the calipers)
The instrument holds the mirror delicately clamped between its pincers; the readout reads "0.0182".

>[5] take mirror 2
Taken.

>[6] open tin
That's already open.

>[7] put oil on mirror 2
(first taking some fish oil)
You dip your finger in and come up with a small glob of pungent fish oil.

You rub a small bit of fish oil onto the reflective surface of the mirror, leaving a barely perceptible smear.

>d. s. s. s. u. e.
Mill Floor
Waves of heat and noise assault you from every corner. Towering above you on all sides are the enormous vats, presses and sundry machinery, the ever-churning inner workings of the paper mill. An opening in the base of the south wall leads back to the maintenance crawlway, and narrow aisles lead in several other directions through the chugging machinery. A grilled catwalk high over your head provides a more direct route across the factory; however, you see no way to get up there from here.

Bolted to the side of one of the machines is a steel ladder, leading up.

Maintenance Access Tunnel
The north end of the access crawlway ends at a sturdy metal hatch. A thick haze of steam hangs in the air, and the heat is like an oven -- the walls and floor are almost blistering to the touch.

Maintenance Access Tunnel
You are roughly at the center of the access crawlway, which stretches north and south from here.

Maintenance Access Tunnel
You are at the southern end of a long, narrow crawlway leading northward into the mill. All around you, through the metallic walls, you can hear the oppressive thumping and grinding of heavy machinery. The air in here is hot and smells of burnt engine oil.

A large metal valve wheel juts out from the middle of one of the many fat, sweating pipes lining the walls. Just to its left is a gauge of some sort.

On the wheel is a towel.

You can't go that way.

You can't go that way.

>u
You can't go that way.

>s
Bare Foundations
The foundations of an older structure lie crumbling in a sunken square of ground, hidden away behind the imposing shadow of the mill wall. Weeds push up through cracked and buckling slabs of concrete; twisted rebar and rusting pipes poke up like the legs of dead insects. The ruins are surrounded on all sides by dense thickets, although narrow, overgrown trails lead northeast and southeast through the underbrush

Set into the base of the mill wall, nearly covered by the thickets, is a metal hatch.

>e
The thickets are too dense in that direction.

>ne
The path curves north, leading you around to the front of the mill.

Entrance to the Paper Mill
The road turns southwest here and runs squarely through the front entrance to the old paper mill. A gate of heavy iron bars blocks the only opening into this charred fortress, although an overgrown path leads around the wall to the south. To the north, a rutted lane threads its way past a row of dilapidated shacks.

>e
Mill Road
The road carries you across a desolate heath of gray, windswept grass. To the south, the black, jagged outline of Anchorhead's steep roofs and sharp, leaning gables cuts across the horizon. The road forks here to the west and east, heading across the railroad tracks in one direction, out toward the seashore in the other.

>scenes
Scene 'Entire Game' playing (for 320 mins now)
Scene 'Day 1' ended
Scene 'Michael Reads' ended
Scene 'Michael Follows' ended
Scene 'Michael Sleeps' ended
Scene 'Day 2' ended
Scene 'Michael Showers' ended
Scene 'Michael Writes' ended
Scene 'Close of Day' playing (for 170 mins now)
Scene 'Day 3' playing (for 135 mins now)
Scene 'Michael Sleeps Again' ended
Scene 'Michael Wanders' ended
Scene 'Out on the Town' playing (for 119 mins now)
Scene 'Good Will Hunting' ended
Scene 'Folks on the Road' ended
Scene 'Folks on the Bridge' playing (for 79 mins now)
Scene 'Michael Snaps' playing (for 12 mins now)
(Scene monitoring now switched on. Type "scenes off" to switch it off again.)

* * *

>u
Workshop
Several workbenches and racks of arcane electronic equipment have been dragged together to form a sort of open laboratory on this wide balcony overlooking the mill. A wide table dominates the area, strewn with precision tools, bits of wire, and scribbled calculations. To the south, a narrow catwalk hangs above the mill floor, and a metal ladder leads down into the machinery below.

On the workbenches are some notes and some arcane electronic equipment.

One of the racks contains a number of circular mirrors, stacked side by side like dishes in a dishwasher.

Prominent among the strange tools scattered across the table is a strange caliper-like instrument.

Tacked up on the wall is a large technical blueprint.

>test 3p
(Testing.)

>[1] x blueprint
The blueprint is a technical schematic for some extremely complicated device, the exact purpose of which is anything but clear. It looks a bit like a telescope, a bit like a microwave oven turned inside out, and a bit like the "industrial laser" from Goldfinger. The inner workings of the device involve a complicated arrangement of lenses and mirrors and a hopeless tangle of circuitry that vaguely resembles several dozen street maps of Manhattan laid across each other. Some of the notations on the circuitry don't even look like technical symbols; they look more like cabbalistic runes.

Next to what must represent the main focusing mirror of the device, someone has written the number "0.0113"; someone else, in another handwriting, has scratched that number out and written below it, "0.0182".

>[2] take calipers
Taken.

>[3] measure mirror 2
(with the calipers)
The instrument holds the mirror delicately clamped between its pincers; the readout reads "0.0182".

>[4] take mirror 2
Taken.

>[5] open tin
That's already open.

>[6] put oil on mirror 2
(first taking some fish oil)
You dip your finger in and come up with a small glob of pungent fish oil.

You rub some fish oil onto mirror labeled #2.

>rules
Rules tracing now switched on. Type "rules off" to switch it off again, or "rules all" to include even rules which do not apply.

[Rule "parse command rule" applies.]

>put oil on mirror 2
[Rule "declare everything initially unmentioned rule" applies.]
[Rule "generate action rule" applies.]
[Rule "announce items from multiple object lists rule" applies.]
[Rule "set pronouns from items from multiple object lists rule" applies.]
[Rule "before stage rule" applies.]
[Rule "Before putting the fish oil on something" applies.]
mirror labeled #2 already has fish oil on it.

[Rule "A first turn sequence rule" applies.]
[Rule "scene change machinery rule" applies.]
[Rule "every turn stage rule" applies.]
[Rule "timed events rule" applies.]
[Rule "player gets rid of the fish oil" applies.]
[Rule "advance time rule" applies.]
[Rule "update chronological records rule" applies.]
[Rule "A last turn sequence rule" applies.]
[Rule "scene change machinery rule" applies.]
[Rule "adjust light rule" applies.]
[Rule "note object acquisitions rule" applies.]
[Rule "notify score changes rule" applies.]
[Rule "parse command rule" applies.]

>i
[Rule "declare everything initially unmentioned rule" applies.]
[Rule "generate action rule" applies.]
[Rule "announce items from multiple object lists rule" applies.]
[Rule "set pronouns from items from multiple object lists rule" applies.]
[Rule "before stage rule" applies.]
[Rule "basic visibility rule" applies.]
[Rule "basic accessibility rule" applies.]
[Rule "keychain-aware carrying requirements rule" applies.]
[Rule "instead stage rule" applies.]
[Rule "Instead of taking inventory" applies.]
You are wearing your trenchcoat, your clothes and your wedding ring.

In addition, you are holding mirror labeled #2, a pair of calipers, your keyring and a hooded robe.

The pockets of your trenchcoat contain an old rusty meat hook, a flashlight, a gold locket, a small copper key, a puzzle box, a strange metal flute, a silver locket, Michael's faculty card, an old tin, a lantern and your umbrella.

Your keyring contains a long steel key (which opens the mill hatch), a tarnished bronze key, a small steel key (which opens the small drawer), an old-fashioned brass key (which opens the attic door), an old-fashioned iron key (which opens the crypt door), a cellar key (which opens the cellar door) and a house key (which opens the front door and the back door).

[Rule "A first turn sequence rule" applies.]
[Rule "scene change machinery rule" applies.]
[Rule "every turn stage rule" applies.]
[Rule "timed events rule" applies.]
[Rule "advance time rule" applies.]
[Rule "update chronological records rule" applies.]
[Rule "A last turn sequence rule" applies.]
[Rule "scene change machinery rule" applies.]
[Rule "adjust light rule" applies.]
[Rule "note object acquisitions rule" applies.]
[Rule "notify score changes rule" applies.]
[Rule "parse command rule" applies.]

* * *

>u
Workshop
Several workbenches and racks of arcane electronic equipment have been dragged together to form a sort of open laboratory on this wide balcony overlooking the mill. A wide table dominates the area, strewn with precision tools, bits of wire, and scribbled calculations. To the south, a narrow catwalk hangs above the mill floor, and a metal ladder leads down into the machinery below.

On the workbenches are some notes and some arcane electronic equipment.

One of the racks contains a number of circular mirrors, stacked side by side like dishes in a dishwasher.

Prominent among the strange tools scattered across the table is a strange caliper-like instrument.

Tacked up on the wall is a large technical blueprint.

>read blueprint
Nothing is written on the blueprint.

>x blueprint
The blueprint is a technical schematic for some extremely complicated device, the exact purpose of which is anything but clear. It looks a bit like a telescope, a bit like a microwave oven turned inside out, and a bit like the "industrial laser" from Goldfinger. The inner workings of the device involve a complicated arrangement of lenses and mirrors and a hopeless tangle of circuitry that vaguely resembles several dozen street maps of Manhattan laid across each other. Some of the notations on the circuitry don't even look like technical symbols; they look more like cabbalistic runes.

Next to what must represent the main focusing mirror of the device, someone has written the number "0.0113"; someone else, in another handwriting, has scratched that number out and written below it, "0.0182".

>take calipers
Taken.

>measure mirror 2
(with the calipers)
The instrument holds the mirror delicately clamped between its pincers; the readout reads "0.0182".

>take mirror 2 / open tin / put oil on mirror 2
I only understood you as far as wanting to take mirror labeled #2.

>take mirror 2. open tin. put oil on mirror 2.
Taken.

That's already open.

(first taking some fish oil)
You dip your finger in and come up with a small glob of pungent fish oil.

You rub some fish oil onto mirror labeled #2.

* * *

>test day3
>--> The following tests are available:
'test mreads'
'test mfollows'
'test man'
'test muzzle'
'test obs'
'test crypt'
'test 1a'
'test 1b'
'test 1c'
'test 1d'
'test 1e'
'test 1f'
'test day1'
'test 2a'
'test 2b'
'test 2c'
'test 2d'
'test 2e'
'test 2f'
'test 2g'
'test 2h'
'test 2i'
'test 2j'
'test 2k'
'test 2l'
'test day2a'
'test day2b'
'test 3a'
'test 3b'
'test 3c'
'test 3d'
'test 3e'
'test 3f'
'test 3g'
'test 3h'
'test 3i'
'test 3j'
'test 3k'
'test 3l'
'test 3m'
'test foo'

* * *

>search overalls
In the overalls is a long steel key.

>take long steel key
You slip the long steel key on to your keyring.

That key might just come in handy; while the woman is looking in the other direction, you quickly pluck it from the overall pocket.

[Your score has just gone up by one point.]

>w
The woman attempts a wan smile as you make ready to leave. "Thank you," she says softly, indicating the stuffed bear. "If you discover anything else, please let me know."

Shanty Town
The road peters out at a wide clearing of rutted mud, flanked by uneven rows of decrepit, clapboard shacks. The town is quiet, almost deserted; only a few bits of loose tarpaper blowing listlessly in the wind betray the overall stillness.

>s
Entrance to the Paper Mill
The road turns southwest here and runs squarely through the front entrance to the old paper mill. A gate of heavy iron bars blocks the only opening into this charred fortress, although an overgrown path leads around the wall to the south. To the north, a rutted lane threads its way past a row of dilapidated shacks.

* * *

>test fo
>--> The following tests are available:
'test mreads'
'test mfollows'
'test man'
'test muzzle'
'test obs'
'test crypt'
'test 1a'
'test 1b'
'test 1c'
'test 1d'
'test 1e'
'test 1f'
'test day1'
'test 2a'
'test 2b'
'test 2c'
'test 2d'
'test 2e'
'test 2f'
'test 2g'
'test 2h'
'test 2i'
'test 2j'
'test 2k'
'test 2l'
'test day2a'
'test day2b'
'test 3a'
'test 3b'
'test 3c'
'test 3d'
'test 3e'
'test 3f'
'test 3g'
'test 3h'
'test 3i'
'test 3j'
'test 3k'
'test 3l'
'test 3m'
'test 3n'
'test foo'

* * *

>e
Churchyard
A low, wrought-iron fence, its spike-tipped bars bent or leaning at crazy angles, surrounds the overgrown yard of this dark, abandoned church. A gap in the fence leads back west, while a bare path beaten through the groping weeds leads around the church to the southeast.

>e
The wrought-iron fence surrounds the entire churchyard; the only way out is to the west, or around that little path to the southeast.

>se
The path bends northeast, around the side of the church.

The path bends northwest, around the side of the church.

Behind the Church
The forest encroaches right up to the iron fence here, some of which is literally buried in the tangled underbrush. There are no doors on this side, although a wooden trap door over by the corner of the building probably leads into a cellar. A path leads southwest, around to the front of the church.

>break lock with hook
You raise the meat hook high over your head and bring it squarely down onto the padlock. The rusted metal casing splits open, the hasp falls loose, and the padlock, now nothing but a broken shell, slides to the ground.

>d
(first opening the trap door)
As you drop to the floor, the trap door suddenly slams shut above you. You hear noises outside -- something thumping against the door, and low voices. You hear someone muttering, and a brief round of unpleasant laughter. Then the voices drift away.

Church Cellar
Centipedes and beetles scurry away across the rotten floorboards as you shine your light across the room. Over in the corner sits a hulking shape of black metal that was probably once a wood-burning furnace; aside from that, the cellar looks empty. A dark alcove, the shadows within too thick to see through, opens in the west wall, and a trap door in the ceiling leads back up to the outside.

At the very edge of your light's glow, you can just make out a horribly suggestive shape lying in the shadows behind the furnace.

>search shape
Gingerly, trying to avoid the worst of the blood, you lift the woman's lapel, hoping to find something -- identification, maybe. Her wallet is missing; however, you do find, tucked into the pocket of her blazer, a small, steel key.

>take small steel key
You already have that.

>i
You are wearing your trenchcoat, your clothes and your wedding ring.

In addition, you are holding a small steel key, an old rusty meat hook and a teddy bear.

The pockets of your trenchcoat contain a flashlight, your keyring, a gold locket, a small copper key, a puzzle box, a strange metal flute, a silver locket, Michael's faculty card, an old tin, a lantern and your umbrella.

Your keyring contains an old-fashioned brass key (which opens the attic door), an old-fashioned iron key (which opens the crypt door), a cellar key (which opens the cellar door) and a house key (which opens the front door and the back door).

>put small steel key on keyring
You put the small steel key on the keyring.

>w
Empty Stairwell
This alcove used to house a stairwell leading up and down; now it contains only a few rotted boards jutting from the walls and an empty shaft dropping down out of sight. Above you hang the broken-off remains of the stairs leading up to the ground floor, the last shattered riser only a couple of tantalizing feet out of reach.

>put all in pockets
old rusty meat hook: You slip the old rusty meat hook into the pocket of your trenchcoat.
teddy bear: You slip the teddy bear into the pocket of your trenchcoat.

>jump
You take a few steps back, draw in a deep breath, and make a dash for the edge. At the last possible second you jump, sailing out over the pit as you make a desperate grab for the bottom riser...

... and catch it.

The riser bends ominously under your weight but doesn't give. Panting, you haul yourself up onto the creaking stairs.

Broken Stairs
The stairs stop short about seven feet shy of the basement floor, the bottom-most steps hanging suspended over an empty shaft that descends beyond sight into the shadowy depths. What's left of the structure creaks and shifts uneasily under your feet. At the top of the stairs to the north, a doorway opens onto the ground floor of the church.

>u. take cloth. e. e. u. u.
Vestibule
A dim antechamber, opening onto the main chapel to the east. To the west, the main doors to the church have been solidly nailed shut, and through a shadowy doorway to the south you can see stairs leading down.

Piled in one dusty corner is a heap of old cloth.

You shake the cloth out, revealing it to be a hooded robe.

Chapel
Broken shards from the shattered the stained glass windows grits under your feet as you step around rows of overturned pews. The dust and cobwebs have been busy here, reclaiming another bit of this town's abandoned history. To the west lies the vestibule; to the east, a small doorway behind the pulpit leads to the back of the church.

The big wooden cross that once hung above the pulpit has fallen, split in half.

On the pulpit is a huge black tome.

You hear a faint, echoing crash from the direction of the Vestibule.

Behind the Chapel
This little room behind the chapel is hardly bigger than a broom closet. A ladder bolted to the wall leads up through a hatch, presumably up into the steeple.

Steeple
A tiny space inside the tip of the church's steeple, barely five feet across, the walls tapering to only two feet across some twelve feet above your head. There is a narrow window, but it seems to have been painted black at some point. The only exit seems to be the ladder from which you just emerged.

An old length of rope dangles down from a square hole cut in the ceiling.

You haul yourself up onto the rope, bringing your whole weight to bear. It holds for about three seconds -- then there is a sharp snap from above you and a muffled clank. The rope falls, spilling you to the floor amidst an untidy tangle of coils.

>take rope. d. w. w.
[** Programming error: tried to read (something) **]
Taken.

Behind the Chapel
This little room behind the chapel is hardly bigger than a broom closet. A ladder bolted to the wall leads up through a hatch, presumably up into the steeple.

Chapel
Broken shards from the shattered the stained glass windows grits under your feet as you step around rows of overturned pews. The dust and cobwebs have been busy here, reclaiming another bit of this town's abandoned history. To the west lies the vestibule; to the east, a small doorway behind the pulpit leads to the back of the church.

The big wooden cross that once hung above the pulpit has fallen, split in half.

On the pulpit is a huge black tome.

Vestibule
A dim antechamber, opening onto the main chapel to the east. To the west, the main doors to the church have been solidly nailed shut, and through a shadowy doorway to the south you can see stairs leading down.

>s
Broken Stairs
The stairs are completely gone, now. All that's left is a narrow ledge overlooking an empty shaft, and a fair portion of the railing still nailed to the wall.

* * *

>tie rope to railing
You tie the rope securely to the railing, letting the other end dangle down into the dark shaft.

>d
Gripping the end of the rope tightly, you lower yourself off the edge and shimmy down into the darkness.

Hanging from the Rope
Your feet dangle over empty space. Looking down, you can barely make out a faint glimmer of water, far below.

>jump
You take a deep breath, shut your eyes tight, say a quick prayer... and let go of the rope.

The heart-stopping plunge lasts only a second or two before you hit shockingly cold water. Your light goes out and blackness envelopes you. Water rushes into your mouth and nose; the stone bottom slams into your side and nearly knocks the wind out of you... and then you find your feet, and your head breaks the surface. Blindly, you thrash about until you find higher ground, and you crawl, choking and sputtering, feeling cold brick beneath your fingers.

Darkness
It is pitch dark, and you can't see a thing.

>light match
You can't see any such thing.

>take match
You can't see any such thing.

>i
You are wearing your trenchcoat, your clothes and your wedding ring.

In addition, you are holding a hooded robe.

The pockets of your trenchcoat contain a teddy bear, an old rusty meat hook, a flashlight, your keyring, a gold locket, a small copper key, a puzzle box, a strange metal flute, a silver locket, Michael's faculty card, an old tin, a lantern and your umbrella.

Your keyring contains a small steel key, an old-fashioned brass key (which opens the attic door), an old-fashioned iron key (which opens the crypt door), a cellar key (which opens the cellar door) and a house key (which opens the front door and the back door).

>turn on light
That's already on.

>turn off light. turn it on.
You switch the flashlight off.

I only understood you as far as wanting to turn the flashlight.

>turn on light.
You switch the flashlight on.

Vaulted Tunnel
The walls of this long, rectangular chamber are made of crumbling brick, not concrete; most likely it was built at some earlier period than the rest of the tunnels. The ceiling is lost in darkness above you, but from the sounds of the echoes it must be pretty high. Water flowing in from the northwestern tunnel has pooled in a depression sunk into the limestone floor, becoming quite deep near the far end.

The shattered wreckage of the church stairway lies half submerged in the water-filled depression. You're lucky to have missed it in your fall..

>nw
Sewer Tunnel
The tunnel is ankle-deep in brackish water, though raised walkways on either side provide relatively dry footing. The walls are slick, the air damp and foul. The main tunnel runs north and southeast. Numerous smaller pipelines lead in all directions, but all are too small for you to crawl through. Iron rungs embedded in the wall lead up through an access shaft, back to the surface.

* * *

>n
Broken Tunnel
This looks to be an older part of the sewer system that has fallen into disrepair. Many of the pipes here have crumbled and are filled with debris.

Set in the low ceiling is an old iron hatch.

>open tin
You open the old tin, revealing a quantity of smelly fish oil.

>put oil on hatch
(first taking some fish oil)
You dip your finger in and come up with a small glob of pungent fish oil.

You rub some fish oil onto the old iron hatch.

>open hatch
The oiled hinges give a little, allowing you to wiggle your fingers further under the door's edge. A sharp tug -- and the door swings down suddenly, spilling filthy water into your face.

You open the old iron hatch.

>u
Outflow Tunnel
From the smell of it, this must be a sewage outflow tunnel. Filthy water swirls past a metal grate to the west and eddies around your hands and knees, on which you are forced to crawl in this cramped cylindrical passageway. To the east, the tunnel narrows still further, terminating about twenty feet further in a circle of dim light.

Set in the floor of the tunnel is an old iron hatch.

>e
You reach the end of the pipe and wriggle your way out, dropping awkwardly to the sand.

Narrow Beach
This narrow strip of beach is tucked away between two outcroppings in the predominantly rocky shoreline, accessible only from a steep, muddy slope to the west. The sand is filthy and strewn with rocks, seaweed, litter and other bits of storm-tossed detritus.

Near the bottom of the slope, a sewage outflow pipe juts out over the beach, about three feet above the ground. A thin stream of acrid-smelling sewer water trickles out over the lip of the pipe, forming a puddle in the sand.

>w
(first opening the fence)
That's not something you can close.

>gonear cans
Alley
This narrow aperture between two buildings is nearly blocked with piles of rotting cardboard boxes and overstuffed garbage cans. Ugly, half-crumbling brick walls to either side totter oppressively over you. The alley ends here at a tall, wooden fence.

High up on the wall of the northern building there is a narrow, transom-style window. One of the garbage cans has been pushed up against the wall directly underneath it.

>x fence
One of the boards seems to be loose down at the bottom; you could probably just squeeze through.

>e
Narrow Beach
This narrow strip of beach is tucked away between two outcroppings in the predominantly rocky shoreline, accessible only from a steep, muddy slope to the west. The sand is filthy and strewn with rocks, seaweed, litter and other bits of storm-tossed detritus.

Near the bottom of the slope, a sewage outflow pipe juts out over the beach, about three feet above the ground. A thin stream of acrid-smelling sewer water trickles out over the lip of the pipe, forming a puddle in the sand.

>w
Alley
This narrow aperture between two buildings is nearly blocked with piles of rotting cardboard boxes and overstuffed garbage cans. Ugly, half-crumbling brick walls to either side totter oppressively over you. The alley ends here at a tall, wooden fence.

High up on the wall of the northern building there is a narrow, transom-style window. One of the garbage cans has been pushed up against the wall directly underneath it.

>e
Narrow Beach
This narrow strip of beach is tucked away between two outcroppings in the predominantly rocky shoreline, accessible only from a steep, muddy slope to the west. The sand is filthy and strewn with rocks, seaweed, litter and other bits of storm-tossed detritus.

Near the bottom of the slope, a sewage outflow pipe juts out over the beach, about three feet above the ground. A thin stream of acrid-smelling sewer water trickles out over the lip of the pipe, forming a puddle in the sand.

Another wave crashes against the rocks, sending a cloud of spray into the air.

>w
Alley
This narrow aperture between two buildings is nearly blocked with piles of rotting cardboard boxes and overstuffed garbage cans. Ugly, half-crumbling brick walls to either side totter oppressively over you. The alley ends here at a tall, wooden fence.

High up on the wall of the northern building there is a narrow, transom-style window. One of the garbage cans has been pushed up against the wall directly underneath it.

>w
You can only exit the alley to the northwest or crawl through the fence to the east. With those cans in place, you might also be able to give the window a try.

>nw
Outside the Real Estate Office
A grim little cul-de-sac, tucked away in a corner of the claustrophobic tangle of narrow, twisting avenues that largely constitute the older portion of Anchorhead. Like most of the streets in this city, it is ancient, shadowy, and leads essentially nowhere. The lane ends here at the real estate agent's office, which lies to the east, and winds its way back toward the center of town to the west. A narrow, garbage-choked alley opens to the southeast.

The office door is open.

>w
There appears to be a commotion of sorts to the south, where a group of townsfolk have gathered.

Narrow Street
As the lane winds along from east to west, it narrows until the steep, jagged rooftops on either side of the street practically touch each other. To the south, a side street leads across Whateley Bridge toward the center of town, and a twisting lane leads up a hill to the northwest. A short flight of steps to the north leads down to the local watering hole.

>e
Outside the Real Estate Office
A grim little cul-de-sac, tucked away in a corner of the claustrophobic tangle of narrow, twisting avenues that largely constitute the older portion of Anchorhead. Like most of the streets in this city, it is ancient, shadowy, and leads essentially nowhere. The lane ends here at the real estate agent's office, which lies to the east, and winds its way back toward the center of town to the west. A narrow, garbage-choked alley opens to the southeast.

The office door is open.

>e
Office
Pallid gray light trickles in through the drawn blinds. The office is deserted, papers still scattered across the top of the desk. The front door lies west, and the file room lies east.

Sitting on the corner of the paper-strewn desk are a telephone and an answering machine.

The office door is open.

Someone seems to have left a cup of coffee sitting out, half-finished and cold.

* * *

>test 3n
(Testing.)

>[1] s
The path curves southwest, leading you into an overgrown area behind the mill.

The path curves southwest, leading you into an overgrown area behind the mill.

Bare Foundations
The foundations of an older structure lie crumbling in a sunken square of ground, hidden away behind the imposing shadow of the mill wall. Weeds push up through cracked and buckling slabs of concrete; twisted rebar and rusting pipes poke up like the legs of dead insects. The ruins are surrounded on all sides by dense thickets, although narrow, overgrown trails lead northeast and southeast through the underbrush.

>[2] search brush
Carefully pushing the prickly branches aside, you find a rusty metal hatch set into the base of the wall.

>[3] unlock hatch
(with the long steel key)
You unlock the mill hatch.

>[4] d
The thickets are too dense in that direction.

>n
(first opening the mill hatch)

Maintenance Access Tunnel
You are at the southern end of a long, narrow crawlway leading northward into the mill. All around you, through the metallic walls, you can hear the oppressive thumping and grinding of heavy machinery. The air in here is hot and smells of burnt engine oil.

A large metal valve wheel juts out from the middle of one of the many fat, sweating pipes lining the walls. Just to its left is a gauge of some sort.

Just as the mechanical noises reach a crescendo, the pipes at the north end of the crawlway suddenly give vent to an enormous gout of superheated steam. The entire north half of the crawlway is momentarily filled with vapor and intense heat, which just as quickly dissipates. The noise behind the walls recedes to a calmer level, and the needle on the gauge swings back down to zero..

* * *

>nw
Outside the Real Estate Office
A grim little cul-de-sac, tucked away in a corner of the claustrophobic tangle of narrow, twisting avenues that largely constitute the older portion of Anchorhead. Like most of the streets in this city, it is ancient, shadowy, and leads essentially nowhere. The lane ends here at the real estate agent's office, which lies to the east, and winds its way back toward the center of town to the west. A narrow, garbage-choked alley opens to the southeast.

The office door is open.

>e
Office
Pallid gray light trickles in through the drawn blinds. The office is deserted, papers still scattered across the top of the desk. The front door lies west, and the file room lies east.

Sitting on the corner of the paper-strewn desk are a telephone and an answering machine.

The office door is open.

Someone seems to have left a cup of coffee sitting out, half-finished and cold.

>unlock small drawer
You lack a key that fits the small drawer.

>i
You are wearing your trenchcoat, your clothes and your wedding ring.

In addition, you are holding a hooded robe.

The pockets of your trenchcoat contain a teddy bear, an old rusty meat hook, a flashlight, your keyring, a gold locket, a small copper key, a puzzle box, a strange metal flute, a silver locket, Michael's faculty card, an old tin, a lantern and your umbrella.

Your keyring contains a small steel key, an old-fashioned brass key (which opens the attic door), an old-fashioned iron key (which opens the crypt door), a cellar key (which opens the cellar door) and a house key (which opens the front door and the back door).

* * *

>test 3l
(Testing.)

>[1] nw

Outside the Real Estate Office
A grim little cul-de-sac, tucked away in a corner of the claustrophobic tangle of narrow, twisting avenues that largely constitute the older portion of Anchorhead. Like most of the streets in this city, it is ancient, shadowy, and leads essentially nowhere. The lane ends here at the real estate agent's office, which lies to the east, and winds its way back toward the center of town to the west. A narrow, garbage-choked alley opens to the southeast.

The office door is open.

>[2] e

Office
Pallid gray light trickles in through the drawn blinds. The office is deserted, papers still scattered across the top of the desk. The front door lies west, and the file room lies east.

Sitting on the corner of the paper-strewn desk are a telephone and an answering machine.

The office door is open.

Someone seems to have left a cup of coffee sitting out, half-finished and cold.

>[3] unlock small drawer
(first taking the keyring)
(with the small steel key)
You unlock the small drawer.

>[4] open it
You open the small drawer, revealing a hastily written letter and a tarnished bronze key.

[Your score has just gone up by two points.]

>[5] take bronze key
You slip the tarnished bronze key on to your keyring.

>[6] w

Outside the Real Estate Office
A grim little cul-de-sac, tucked away in a corner of the claustrophobic tangle of narrow, twisting avenues that largely constitute the older portion of Anchorhead. Like most of the streets in this city, it is ancient, shadowy, and leads essentially nowhere. The lane ends here at the real estate agent's office, which lies to the east, and winds its way back toward the center of town to the west. A narrow, garbage-choked alley opens to the southeast.

The office door is open.

>open it
[Your score has just gone up by two points.]

>look in small drawer
In the small drawer are a hastily written letter and a tarnished bronze key.

>take bronze key
You slip the tarnished bronze key on to your keyring.

>w
Outside the Real Estate Office
A grim little cul-de-sac, tucked away in a corner of the claustrophobic tangle of narrow, twisting avenues that largely constitute the older portion of Anchorhead. Like most of the streets in this city, it is ancient, shadowy, and leads essentially nowhere. The lane ends here at the real estate agent's office, which lies to the east, and winds its way back toward the center of town to the west. A narrow, garbage-choked alley opens to the southeast.

The office door is open.

>w
There appears to be a commotion of sorts to the south, where a group of townsfolk have gathered.

Narrow Street
As the lane winds along from east to west, it narrows until the steep, jagged rooftops on either side of the street practically touch each other. To the south, a side street leads across Whateley Bridge toward the center of town, and a twisting lane leads up a hill to the northwest. A short flight of steps to the north leads down to the local watering hole.

>w
Junction
To the north, a gap in the crowded press of gloomy buildings opens onto a country lane, heading out over a grassy heath. The main street continues to the east, while to the northwest, over the top of a steep rise, you can just make out the vaulted rooftops of the university.

>e
There appears to be a commotion of sorts to the south, where a group of townsfolk have gathered.

Narrow Street
As the lane winds along from east to west, it narrows until the steep, jagged rooftops on either side of the street practically touch each other. To the south, a side street leads across Whateley Bridge toward the center of town, and a twisting lane leads up a hill to the northwest. A short flight of steps to the north leads down to the local watering hole.

>s
A group of wary-looking townsfolk has gathered, keeping a watchful eye on the street from the bridge.

The townsfolk turn toward you as you walk blithely up to them.

Suddenly, someone's finger jabs out at you. "It's the woman!" He shouts. "Get her!!"

>n
Narrow Street
As the lane winds along from east to west, it narrows until the steep, jagged rooftops on either side of the street practically touch each other. To the south, a side street leads across Whateley Bridge toward the center of town, and a twisting lane leads up a hill to the northwest. A short flight of steps to the north leads down to the local watering hole.

There is no time to run. Heavy boots on the cobblestones; hands lunging toward you -- they are everywhere, grabbing you from every side, immobilizing you. Someone's huge, calloused paw closes around your windpipe and starts to squeeze. Just before you black out, you can feel yourself being lifted off your feet...

    *** You have died ***

In that game you scored 33 out of a possible 0, in 280 turns.

Would you like to RESTART, RESTORE a saved game, QUIT or UNDO the last command?

>restart
Informhead
An Interactive Fiction by Ed Peters
Release 1 / Serial number 230616 / Inform 7 v10.1.2 / D

Outside the Real Estate Office
A grim little cul-de-sac, tucked away in a corner of the claustrophobic tangle of narrow, twisting avenues that largely constitute the older portion of Anchorhead. Like most of the streets in this city, it is ancient, shadowy, and leads essentially nowhere. The lane ends here at the real estate agent's office, which lies to the east, and winds its way back toward the center of town to the west. A narrow, garbage-choked alley opens to the southeast.

* * *

>w
There appears to be a commotion of sorts to the south, where a group of townsfolk have gathered.

Narrow Street
As the lane winds along from east to west, it narrows until the steep, jagged rooftops on either side of the street practically touch each other. To the south, a side street leads across Whateley Bridge toward the center of town, and a twisting lane leads up a hill to the northwest. A short flight of steps to the north leads down to the local watering hole.

There appears to be a commotion of sorts to the south, where a group of townsfolk have gathered.

>x commotion
The townsfolk have gathered in a small crowd on Whateley Bridge. Word of your snooping must have gotten around quickly; these fellows are obviously not taking any chances on the possibility of you escaping from the church, and are keeping a sharp lookout.

>nw
Twisting Lane
The lane narrows here to little more than a badly cobbled sidewalk as it wends its way up through a series of tortuous bends and switchbacks. In some places, the street is so steep that steps have been cut into it, worn down over the years and slick with moss. Your progress is blocked at the top of the street by a blankbrick wall.

Someone has sprayed graffiti across the wall in black spray paint.

* * *

>i
You are wearing your trenchcoat, your clothes and your wedding ring.

In addition, you are holding a broom, your keyring, a flashlight, a silver locket and Michael's faculty card.

The pockets of your trenchcoat contain an old tin, a lantern, a flask and your umbrella.

Your keyring contains a cellar key (which opens the cellar door) and a house key (which opens the front door).

>search crates
You spend some time poking dispiritedly through boxes of second-hand table settings, discarded shoes and outdated encyclopedias, but the only thing you manage to dig up is an old cardboard box full of newspaper clippings, which might make interesting reading later if you can find the time. The only thing at all noteworthy about the room, in fact, is that it desperately wants cleaning; there's even a big, nasty-looking spider web in a corner behind one of the crates.

* * *

>sweep web with broom
With a single sweep of the broom, you clear the spider web away.

>take key
(the old-fashioned iron key)
(putting Michael's faculty card into the trenchcoat to make room)
You slip Michael's faculty card into the pocket of your trenchcoat.

You slide the old-fashioned iron key on to your keyring.
handling the noun ...
moving the noun ...

[Your score has just gone up by one point.]

>i
You are wearing your trenchcoat, your clothes and your wedding ring.

In addition, you are holding an old-fashioned iron key, a broom, your keyring, a flashlight and a silver locket.

The pockets of your trenchcoat contain Michael's faculty card, an old tin, a lantern, a flask and your umbrella.

Your keyring contains a cellar key (which opens the cellar door) and a house key (which opens the front door).

>purloin tin
[Purloined.]

* * *

>open tin
You open the old tin, revealing a quantity of smelly fish oil.

>put oil on clippings
(first taking some fish oil)
You dip your finger in and come up with a small glob of pungent fish oil.

You rub some fish oil onto the newspaper clippings.

>z
Time passes.

>take oil
You dip your finger in and come up with a small glob of pungent fish oil.

* * *

>z
Time passes.

Not knowing what else to do with it, you wipe the nasty fish oil off on the leg of your pants.

>z
Time passes.

>put oil on broom
(first taking some fish oil)
You dip your finger in and come up with a small glob of pungent fish oil.

You rub some fish oil onto the broom.

>oil broom
The broom does not look like it needs oiling.

>i
You are wearing your trenchcoat, your clothes and your wedding ring.

In addition, you are holding an old tin, an old-fashioned iron key, a broom, your keyring, a flashlight and a silver locket.

The pockets of your trenchcoat contain Michael's faculty card, a lantern, a flask and your umbrella.

Your keyring contains a cellar key (which opens the cellar door) and a house key (which opens the front door).

>u
You can't go that way.

>n
Cellar
The old, flagstone walls gleam with unwholesome-smelling moisture, and the sagging timbers creak uneasily above your head. Ancient, frayed wiring festoons the ceiling like some strange species of clinging vine. Portions of the cellar extend south and east into the clammy darkness, though you could always beat a hasty retreat up the stairs to the north.

One largish bundle of wires leads down to a rusty old fuse cabinet bolted to the far wall.

>u
Pantry
The pantry is empty save for a layer of dust on the shelves. A door to the south leads down to the cellar, or you can return to the kitchen to the southeast.

>se
Kitchen
Where once pots and skillets and various utensils hung in profusion, the kitchen walls are now merely ranks of dusty cabinets and a forest of empty hooks. Doorways lead east and south, a small pantry lies to the northwest, and the back door to the north leads out of the house.

>open cabinet
The cabinets are not, after all, still stocked -- much to your relief. There's nothing in there but an old book of matches.

You open the kitchen cabinet, revealing a book of matches.

>take matches
(putting the silver locket into the trenchcoat to make room)
You slip the silver locket into the pocket of your trenchcoat.

You're carrying too many things already.

>put all in pockets
old tin: You slip the old tin into the pocket of your trenchcoat.
old-fashioned iron key: You slip the old-fashioned iron key into the pocket of your trenchcoat.
broom: You slip the broom into the pocket of your trenchcoat.
keyring: You slip the keyring into the pocket of your trenchcoat.
flashlight: You slip the flashlight into the pocket of your trenchcoat.

>take matches
Taken.

>drop broom
You haven't got that.

>take broom
Taken.

>drop it
Dropped.

>w
You can't go that way.

>nw
Pantry
The pantry is empty save for a layer of dust on the shelves. A door to the south leads down to the cellar, or you can return to the kitchen to the southeast.

>d
Cellar
The old, flagstone walls gleam with unwholesome-smelling moisture, and the sagging timbers creak uneasily above your head. Ancient, frayed wiring festoons the ceiling like some strange species of clinging vine. Portions of the cellar extend south and east into the clammy darkness, though you could always beat a hasty retreat up the stairs to the north.

One largish bundle of wires leads down to a rusty old fuse cabinet bolted to the far wall.

>i
You are wearing your trenchcoat, your clothes and your wedding ring.

In addition, you are holding a book of matches.

The pockets of your trenchcoat contain a flashlight, your keyring, an old-fashioned iron key, an old tin, a silver locket, Michael's faculty card, a lantern, a flask and your umbrella.

Your keyring contains a cellar key (which opens the cellar door) and a house key (which opens the front door).

>turn of light
I only understood you as far as wanting to turn the book of matches.

>turn off light
You switch the flashlight off.

It is now pitch dark in here!

>light a match
One of the matches starts to burn.

Cellar
The old, flagstone walls gleam with unwholesome-smelling moisture, and the sagging timbers creak uneasily above your head. Ancient, frayed wiring festoons the ceiling like some strange species of clinging vine. Portions of the cellar extend south and east into the clammy darkness, though you could always beat a hasty retreat up the stairs to the north.

One largish bundle of wires leads down to a rusty old fuse cabinet bolted to the far wall.

>light lantern
This dangerous act would achieve little.

>light lantern with match
The lantern is now lit.

Ouch! You drop the match as it burns down to your fingers.

>l
Cellar
The old, flagstone walls gleam with unwholesome-smelling moisture, and the sagging timbers creak uneasily above your head. Ancient, frayed wiring festoons the ceiling like some strange species of clinging vine. Portions of the cellar extend south and east into the clammy darkness, though you could always beat a hasty retreat up the stairs to the north.

One largish bundle of wires leads down to a rusty old fuse cabinet bolted to the far wall.

>snuff lantern
You blow the lantern out.

It is now pitch dark in here!

>u
Darkness
It is pitch dark, and you can't see a thing.

>n
You can't go that way.

>u
You can't go that way.

>u
You can't go that way.

>turn on flashlight
You switch the flashlight on.

Pantry
The pantry is empty save for a layer of dust on the shelves. A door to the south leads down to the cellar, or you can return to the kitchen to the southeast.

>se
Kitchen
Where once pots and skillets and various utensils hung in profusion, the kitchen walls are now merely ranks of dusty cabinets and a forest of empty hooks. Doorways lead east and south, a small pantry lies to the northwest, and the back door to the north leads out of the house.

You can see a broom here.

* * *

>jump
You take a deep breath, shut your eyes tight, say a quick prayer... and let go of the rope.

The heart-stopping plunge lasts only a second or two before you hit shockingly cold water. Your light goes out and blackness envelopes you. Water rushes into your mouth and nose; the stone bottom slams into your side and nearly knocks the wind out of you... and then you find your feet, and your head breaks the surface. Blindly, you thrash about until you find higher ground, and you crawl, choking and sputtering, feeling cold brick beneath your fingers.

Darkness
It is pitch dark, and you can't see a thing.

>i
You are wearing your clothes, your trenchcoat and your wedding ring.

The pockets of your trenchcoat contain a flashlight.

* * *

>turn on light
That's already on.

>i
You are wearing your clothes, your trenchcoat and your wedding ring.

The pockets of your trenchcoat contain a flashlight.

>take flashlight
Taken.

>turn it off
You switch the flashlight off.

>turn it on
You switch the flashlight on.

Vaulted Tunnel
The walls of this long, rectangular chamber are made of crumbling brick, not concrete; most likely it was built at some earlier period than the rest of the tunnels. The ceiling is lost in darkness above you, but from the sounds of the echoes it must be pretty high. Water flowing in from the northwestern tunnel has pooled in a depression sunk into the limestone floor, becoming quite deep near the far end.

The shattered wreckage of the church stairway lies half submerged in the water-filled depression. You're lucky to have missed it in your fall..

You can see a hooded robe, your keyring, your umbrella and an animal's skull here.

>take all
hooded robe: Taken.
keyring: Taken.
umbrella: Taken.
animal's skull: Taken.

>put all in pockets
animal's skull: You slip the animal's skull into the pocket of your trenchcoat.
umbrella: You slip the umbrella into the pocket of your trenchcoat.
keyring: You slip the keyring into the pocket of your trenchcoat.
hooded robe: You slip the hooded robe into the pocket of your trenchcoat.
flashlight: You slip the flashlight into the pocket of your trenchcoat.

>i
You are wearing your clothes, your trenchcoat and your wedding ring.

The pockets of your trenchcoat contain a flashlight, a hooded robe, your keyring, your umbrella and an animal's skull.

* * *

Informhead
An Interactive Fiction by Ed Peters
Release 1 / Serial number 230628 / Inform 7 v10.1.2 / D

Outside the Real Estate Office
A grim little cul-de-sac, tucked away in a corner of the claustrophobic tangle of narrow, twisting avenues that largely constitute the older portion of Anchorhead. Like most of the streets in this city, it is ancient, shadowy, and leads essentially nowhere. The lane ends here at the real estate agent's office, which lies to the east, and winds its way back toward the center of town to the west. A narrow, garbage-choked alley opens to the southeast.

>w
Narrow Street
As the lane winds along from east to west, it narrows until the steep, jagged rooftops on either side of the street practically touch each other. To the south, a side street leads across Whateley Bridge toward the center of town, and a twisting lane leads up a hill to the northwest. A short flight of steps to the north leads down to the local watering hole.

* * *

>s
Whateley Bridge
A hoary monument of crumbling, moss-eaten flagstones, Whateley Bridge is possibly older than any other structure in the entire city. Ponderously it spans the dark, torpid waters of the Miskaton River, connecting the north and south halves of the city and occasionally raining bits of gravel and mortar from its underside into the water. It looks just wide enough for two cars to pass each other between the flanking stone parapets, but you wouldn't volunteer to try it.

>s
Town Square
A wide expanse of uneven pavestones lies open to the sky, bordered on all sides by the leaning, steep-roofed architecture that looms over everything in this city. The municipal courthouse stands at the south end of the square, next to the mouth of a dark, narrow alley to the southwest. Avenues to the west and east lead back into the cramped and ingrown streets, while to the north lies Whateley Bridge.

In the center of the square, rising from a circular lawn of unhealthy-looking grass and weeds, stands a strange, stone obelisk. It seems to be a monument of some sort, although you can see no plaque or marker anywhere near it.

The rain slackens off momentarily to a weak drizzle, then returns afresh in a brief, freezing downpour.

>w
Dark Corner
The rooftops above you lean so close together as to nearly block out the sky altogether, making this a particularly dark and unpleasant section of the city. The street leads away to the east, and a shadowy driveway leads through a high brick wall to the south.

* * *

>s
Asylum Courtyard
The grim, white-washed edifice of Danvers Asylum bounds this tiny, shadowed courtyard to the south, its narrow, barred windows staring blankly down at you like ranks of shriveled, empty eye sockets. You can escape through a narrow gateway in the high, brick wall to the north.

>w
The asylum grounds are surrounded by a high brick wall, and the only way back to the outside world is to the north.

>go4
Padded Cell
You are in a padded cell, the kind typically reserved for raving lunatics. The room is barely eight feet by eight feet square, with walls and floor of concrete covered with thick, quilted padding. The door in the west wall is also covered with padding, except for a tiny observation window about five feet up, from which a feeble light trickles in.

>i
You are wearing your clothes and your wedding ring.

* * *

>w
Junction
To the north, a gap in the crowded press of gloomy buildings opens onto a country lane, heading out over a grassy heath. The main street continues to the east, while to the northwest, over the top of a steep rise, you can just make out the vaulted rooftops of the university.

>n
Mill Road
The road carries you across a desolate heath of gray, windswept grass. To the south, the black, jagged outline of Anchorhead's steep roofs and sharp, leaning gables cuts across the horizon. The road forks here to the west and east, heading across the railroad tracks in one direction, out toward the seashore in the other.

>w
As you cross the railroad tracks, the air becomes warmer, more dingy, and slightly more difficult to breathe.

Entrance to the Paper Mill
The road turns southwest here and runs squarely through the front entrance to the old paper mill. A gate of heavy iron bars blocks the only opening into this charred fortress, although an overgrown path leads around the wall to the south. To the north, a rutted lane threads its way past a row of dilapidated shacks.

>n
Shanty Town
The road peters out at a wide clearing of rutted mud, flanked by uneven rows of decrepit, clapboard shacks. The town is quiet, almost deserted; only a few bits of loose tarpaper blowing listlessly in the wind betray the overall stillness.

* * *

>w
As you cross the railroad tracks, the air becomes warmer, more dingy, and slightly more difficult to breathe.

Entrance to the Paper Mill
The road turns southwest here and runs squarely through the front entrance to the old paper mill. A gate of heavy iron bars blocks the only opening into this charred fortress, although an overgrown path leads around the wall to the south. To the north, a rutted lane threads its way past a row of dilapidated shacks.

>w
The road goes north and east from here. The mill gate lies southwest, and an overgrown trail leads south.

>s
The path curves southwest, leading you into an overgrown area behind the mill.

The path curves southwest, leading you into an overgrown area behind the mill.

Bare Foundations
The foundations of an older structure lie crumbling in a sunken square of ground, hidden away behind the imposing shadow of the mill wall. Weeds push up through cracked and buckling slabs of concrete; twisted rebar and rusting pipes poke up like the legs of dead insects. The ruins are surrounded on all sides by dense thickets, although narrow, overgrown trails lead northeast and southeast through the underbrush.

>search thicket
Carefully pushing the prickly branches aside, you find a rusty metal hatch set into the base of the wall.

>l
Bare Foundations
The foundations of an older structure lie crumbling in a sunken square of ground, hidden away behind the imposing shadow of the mill wall. Weeds push up through cracked and buckling slabs of concrete; twisted rebar and rusting pipes poke up like the legs of dead insects. The ruins are surrounded on all sides by dense thickets, although narrow, overgrown trails lead northeast and southeast through the underbrush

Set into the base of the mill wall, nearly covered by the thickets, is a metal hatch.

In the north wall is a small metal door.

* * *

>n
Although these hallowed halls of learning probably hold a veritable trove of knowledge, you are no longer a student, and the only building you have any business in is the library.

>w
University Library
Shadows roost thickly in the vaulted ceiling, and small, green-shaded desk lamps cast pools of warm radiance here and there around the library's dim interior. You pause a moment to let the hushed peacefulness of this place soak in -- a welcome relief from the unsettling events of the day. An exit lies east, and a small alcove to the north houses the circulation counter.

Peering through the shadows, you spot your husband sitting at one of the reading desks, absorbed in some sort of weighty tome and clearly oblivious to the time.

>n
Circulation Desk
A high counter divides the public portion of the library from the reserved stacks -- all the more esoteric and mysterious volumes from the university's collection. If anything, the area behind the counter is even more shadowy than the side you're on. The main reading area lies south.

Hanging on the wall next to the counter is a small, printed sign. Beneath the sign sits a heavy, dog-eared register, and sitting next to the register is a bell.

>ring bell
Ding!

A moment later, the gaunt and fishy-eyed librarian emerges silently from the shadows behind the counter.

>ask librarian about greene
The librarian says nothing. Slowly, very slowly, she looks you up and down, and then, just as slowly, she turns to look at the sign posted over the counter. Finally, agonizingly slowly, she turns back to you, and stares at you with a vague, unblinking air of disapproval.

*** Run-time problem P29: Attempt to see if a snippet of text matches something which is not a topic.

The librarian just looks at you.

* * *

>w
University Library
Shadows roost thickly in the vaulted ceiling, and small, green-shaded desk lamps cast pools of warm radiance here and there around the library's dim interior. You pause a moment to let the hushed peacefulness of this place soak in -- a welcome relief from the unsettling events of the day. An exit lies east, and a small alcove to the north houses the circulation counter.

Peering through the shadows, you spot your husband sitting at one of the reading desks, absorbed in some sort of weighty tome and clearly oblivious to the time.

Michael turns to a new page in the book and begins reading intently.

>n
Circulation Desk
A high counter divides the public portion of the library from the reserved stacks -- all the more esoteric and mysterious volumes from the university's collection. If anything, the area behind the counter is even more shadowy than the side you're on. The main reading area lies south.

Hanging on the wall next to the counter is a small, printed sign. Beneath the sign sits a heavy, dog-eared register, and sitting next to the register is a bell.

* * *

>ring bell
Ding!

A moment later, the gaunt and fishy-eyed librarian emerges silently from the shadows behind the counter.

>ask librarian about greene
Foo.

* * *

>w
The street goes east and northwest, or you can take the road out of town to the north.

>n
Mill Road
The road carries you across a desolate heath of gray, windswept grass. To the south, the black, jagged outline of Anchorhead's steep roofs and sharp, leaning gables cuts across the horizon. The road forks here to the west and east, heading across the railroad tracks in one direction, out toward the seashore in the other.

* * *

>w
As you cross the railroad tracks, the air becomes warmer, more dingy, and slightly more difficult to breathe.

Entrance to the Paper Mill
The road turns southwest here and runs squarely through the front entrance to the old paper mill. A gate of heavy iron bars blocks the only opening into this charred fortress, although an overgrown path leads around the wall to the south. To the north, a rutted lane threads its way past a row of dilapidated shacks.

>sw
The road goes north and east from here. The mill gate lies southwest, and an overgrown trail leads south.

>w
The road goes north and east from here. The mill gate lies southwest, and an overgrown trail leads south.

* * *

>s
The path curves southwest, leading you into an overgrown area behind the mill.

The path curves southwest, leading you into an overgrown area behind the mill.

Bare Foundations
The foundations of an older structure lie crumbling in a sunken square of ground, hidden away behind the imposing shadow of the mill wall. Weeds push up through cracked and buckling slabs of concrete; twisted rebar and rusting pipes poke up like the legs of dead insects. The ruins are surrounded on all sides by dense thickets, although narrow, overgrown trails lead northeast and southeast through the underbrush.

>search bushes
You can't see any such thing.

>search thicket
Carefully pushing the prickly branches aside, you find a rusty metal hatch set into the base of the wall.

* * *

>l
Bare Foundations
The foundations of an older structure lie crumbling in a sunken square of ground, hidden away behind the imposing shadow of the mill wall. Weeds push up through cracked and buckling slabs of concrete; twisted rebar and rusting pipes poke up like the legs of dead insects. The ruins are surrounded on all sides by dense thickets, although narrow, overgrown trails lead northeast and southeast through the underbrush.

Set into the base of the mill wall, nearly covered by the thickets, is a metal hatch.

>purloin long steel key
[Purloined.]

>unlock hatch
You lack a key that fits the hatch.

* * *

Informhead
An Interactive Fiction by Ed Peters
Release 1 / Serial number 230628 / Inform 7 v10.1.2 / D

Outside the Real Estate Office
A grim little cul-de-sac, tucked away in a corner of the claustrophobic tangle of narrow, twisting avenues that largely constitute the older portion of Anchorhead. Like most of the streets in this city, it is ancient, shadowy, and leads essentially nowhere. The lane ends here at the real estate agent's office, which lies to the east, and winds its way back toward the center of town to the west. A narrow, garbage-choked alley opens to the southeast.

>w. w. w.
Narrow Street
As the lane winds along from east to west, it narrows until the steep, jagged rooftops on either side of the street practically touch each other. To the south, a side street leads across Whateley Bridge toward the center of town, and a twisting lane leads up a hill to the northwest. A short flight of steps to the north leads down to the local watering hole.

Junction
To the north, a gap in the crowded press of gloomy buildings opens onto a country lane, heading out over a grassy heath. The main street continues to the east, while to the northwest, over the top of a steep rise, you can just make out the vaulted rooftops of the university.

The street goes east and northwest, or you can take the road out of town to the north.

>n. w. w. s.
Mill Road
The road carries you across a desolate heath of gray, windswept grass. To the south, the black, jagged outline of Anchorhead's steep roofs and sharp, leaning gables cuts across the horizon. The road forks here to the west and east, heading across the railroad tracks in one direction, out toward the seashore in the other.

As you cross the railroad tracks, the air becomes warmer, more dingy, and slightly more difficult to breathe.

Entrance to the Paper Mill
The road turns southwest here and runs squarely through the front entrance to the old paper mill. A gate of heavy iron bars blocks the only opening into this charred fortress, although an overgrown path leads around the wall to the south. To the north, a rutted lane threads its way past a row of dilapidated shacks.

The road goes north and east from here. The mill gate lies southwest, and an overgrown trail leads south.

The path curves southwest, leading you into an overgrown area behind the mill.

The path curves southwest, leading you into an overgrown area behind the mill.

Bare Foundations
The foundations of an older structure lie crumbling in a sunken square of ground, hidden away behind the imposing shadow of the mill wall. Weeds push up through cracked and buckling slabs of concrete; twisted rebar and rusting pipes poke up like the legs of dead insects. The ruins are surrounded on all sides by dense thickets, although narrow, overgrown trails lead northeast and southeast through the underbrush.

>search thicket
Carefully pushing the prickly branches aside, you find a rusty metal hatch set into the base of the wall.

>l
Bare Foundations
The foundations of an older structure lie crumbling in a sunken square of ground, hidden away behind the imposing shadow of the mill wall. Weeds push up through cracked and buckling slabs of concrete; twisted rebar and rusting pipes poke up like the legs of dead insects. The ruins are surrounded on all sides by dense thickets, although narrow, overgrown trails lead northeast and southeast through the underbrush

Set into the base of the mill wall, nearly covered by the thickets, is a metal hatch.

>x hatch
It's just an ordinary-looking metal hatch.

>purloin long steel key
[Purloined.]

>unlock hatch
You lack a key that fits the mill hatch.

>i
You are wearing your clothes, your trenchcoat and your wedding ring.

In addition, you are holding a long steel key, your umbrella and your keyring.

>put key on keyring
You put the long steel key on the keyring.

>unlock hatch
You lack a key that fits the mill hatch.

>x long steel key
Its shape is rather odd -- a long, cylindrical barrel with several rows of peg-like teeth set radially around it.

* * *

Informhead
An Interactive Fiction by Ed Peters
Release 1 / Serial number 230628 / Inform 7 v10.1.2 / D

Outside the Real Estate Office
A grim little cul-de-sac, tucked away in a corner of the claustrophobic tangle of narrow, twisting avenues that largely constitute the older portion of Anchorhead. Like most of the streets in this city, it is ancient, shadowy, and leads essentially nowhere. The lane ends here at the real estate agent's office, which lies to the east, and winds its way back toward the center of town to the west. A narrow, garbage-choked alley opens to the southeast.

>w. w. w. n. w. s.
Narrow Street
As the lane winds along from east to west, it narrows until the steep, jagged rooftops on either side of the street practically touch each other. To the south, a side street leads across Whateley Bridge toward the center of town, and a twisting lane leads up a hill to the northwest. A short flight of steps to the north leads down to the local watering hole.

Junction
To the north, a gap in the crowded press of gloomy buildings opens onto a country lane, heading out over a grassy heath. The main street continues to the east, while to the northwest, over the top of a steep rise, you can just make out the vaulted rooftops of the university.

The street goes east and northwest, or you can take the road out of town to the north.

Mill Road
The road carries you across a desolate heath of gray, windswept grass. To the south, the black, jagged outline of Anchorhead's steep roofs and sharp, leaning gables cuts across the horizon. The road forks here to the west and east, heading across the railroad tracks in one direction, out toward the seashore in the other.

As you cross the railroad tracks, the air becomes warmer, more dingy, and slightly more difficult to breathe.

Entrance to the Paper Mill
The road turns southwest here and runs squarely through the front entrance to the old paper mill. A gate of heavy iron bars blocks the only opening into this charred fortress, although an overgrown path leads around the wall to the south. To the north, a rutted lane threads its way past a row of dilapidated shacks.

The path curves southwest, leading you into an overgrown area behind the mill.

The path curves southwest, leading you into an overgrown area behind the mill.

Bare Foundations
The foundations of an older structure lie crumbling in a sunken square of ground, hidden away behind the imposing shadow of the mill wall. Weeds push up through cracked and buckling slabs of concrete; twisted rebar and rusting pipes poke up like the legs of dead insects. The ruins are surrounded on all sides by dense thickets, although narrow, overgrown trails lead northeast and southeast through the underbrush.

>search bush
Carefully pushing the prickly branches aside, you find a rusty metal hatch set into the base of the wall.

>l
Bare Foundations
The foundations of an older structure lie crumbling in a sunken square of ground, hidden away behind the imposing shadow of the mill wall. Weeds push up through cracked and buckling slabs of concrete; twisted rebar and rusting pipes poke up like the legs of dead insects. The ruins are surrounded on all sides by dense thickets, although narrow, overgrown trails lead northeast and southeast through the underbrush

Set into the base of the mill wall, nearly covered by the thickets, is a metal hatch.

>purloin steel key
(the small steel key)
[Purloined.]

>purloin steel key
(the small steel key)
[Purloined.]

>purloin long
[Purloined.]

>i
You are wearing your clothes, your trenchcoat and your wedding ring.

In addition, you are holding a long steel key, a small steel key, your umbrella and your keyring.

>purloin light
[Purloined.]

>purloin towel
[Purloined.]

>n
(first opening the mill hatch)
(first unlocking the mill hatch)
(with the long steel key)

Darkness
It is pitch dark, and you can't see a thing.

Just as the mechanical noises reach a crescendo, the pipes at the north end of the crawlway suddenly give vent to an enormous gout of superheated steam. The entire north half of the crawlway is momentarily filled with vapor and intense heat, which just as quickly dissipates. The noise behind the walls recedes to a calmer level, and the needle on the gauge swings back down to zero..

>turn on light
You switch the flashlight on.

Maintenance Access Tunnel
You are at the southern end of a long, narrow crawlway leading northward into the mill. All around you, through the metallic walls, you can hear the oppressive thumping and grinding of heavy machinery. The air in here is hot and smells of burnt engine oil.

A large metal valve wheel juts out from the middle of one of the many fat, sweating pipes lining the walls. Just to its left is a gauge of some sort.

>put towel on wheel
You drape the towel over the wheel.

The noise of machinery is growing steadily louder.

>turn wheel
You grip the sides of the wheel -- even through the towel, you can feel the heat radiating from it -- and haul it clockwise with all your strength. It squeaks reluctantly at first, then gives all at once. From down the corridor you hear an enormous hissing rush as steam is vented from the pipes, and the needle in the gauge drops abruptly down to zero..

>n
The air grows hotter the farther in you go, and it is becoming difficult to breathe.

Maintenance Access Tunnel
You are roughly at the center of the access crawlway, which stretches north and south from here.

>n
Maintenance Access Tunnel
The north end of the access crawlway ends at a sturdy metal hatch. A thick haze of steam hangs in the air, and the heat is like an oven -- the walls and floor are almost blistering to the touch.

>pull handle
You shove the handle down, and it remains in the lowered position when you let go. Behind the metal walls you can hear mechanisms clanking into gear, and a faint, rapid ticking sound.

>z
Time passes.

>z
Time passes.

You hear a heavy clunking sound from within the hatch.

>n
(first opening the maintenance hatch)
With a sharp tug, the heavy metal door swings open.

Mill Floor
Waves of heat and noise assault you from every corner. Towering above you on all sides are the enormous vats, presses and sundry machinery, the ever-churning inner workings of the paper mill. An opening in the base of the south wall leads back to the maintenance crawlway, and narrow aisles lead in several other directions through the chugging machinery. A grilled catwalk high over your head provides a more direct route across the factory; however, you see no way to get up there from here.

Bolted to the side of one of the machines is a steel ladder, leading up.

>u
Workshop
Several workbenches and racks of arcane electronic equipment have been dragged together to form a sort of open laboratory on this wide balcony overlooking the mill. A wide table dominates the area, strewn with precision tools, bits of wire, and scribbled calculations. To the south, a narrow catwalk hangs above the mill floor, and a metal ladder leads down into the machinery below.

On the workbenches are some notes and some arcane electronic equipment.

One of the racks contains a number of circular mirrors, stacked side by side like dishes in a dishwasher.

Prominent among the strange tools scattered across the table is a strange caliper-like instrument.

Tacked up on the wall is a large technical blueprint.

>x rack
The rack has four slots labeled one through four.

In the rack are TODO.

In the rack of mirrors are mirror labeled #1, mirror labeled #2, mirror labeled #3 and mirror labeled #4.

>measure 2
You don't have the proper instruments for taking accurate measurements.

>take caliper
You can't see any such thing.

>take calipers
(putting the keyring into the trenchcoat to make room)
You slip the keyring into the pocket of your trenchcoat.

Taken.

>measure 2
(with the calipers)
The instrument holds the mirror delicately clamped between its pincers; the readout reads "0.0182".

>measure 3
(with the calipers)
The instrument holds the mirror delicately clamped between its pincers; the readout reads "0.0113".

>measure 4
(with the calipers)
The instrument holds the mirror delicately clamped between its pincers; the readout reads "0.0166".

* * *

>search foundation
You can't see any such thing.

>search bush
You can't see any such thing.

>search brush
Carefully pushing the prickly branches aside, you find a rusty metal hatch set into the base of the wall.

>n
(first opening the mill hatch)
(first unlocking the mill hatch)
You lack a key that fits the mill hatch.

>purloin long steel key
[Purloined.]

>purloin light
[Purloined.]

>n
(first opening the mill hatch)
(first unlocking the mill hatch)
(with the long steel key)

Maintenance Access Tunnel
You are at the southern end of a long, narrow crawlway leading northward into the mill. All around you, through the metallic walls, you can hear the oppressive thumping and grinding of heavy machinery. The air in here is hot and smells of burnt engine oil.

A large metal valve wheel juts out from the middle of one of the many fat, sweating pipes lining the walls. Just to its left is a gauge of some sort.

Just as the mechanical noises reach a crescendo, the pipes at the north end of the crawlway suddenly give vent to an enormous gout of superheated steam. The entire north half of the crawlway is momentarily filled with vapor and intense heat, which just as quickly dissipates. The noise behind the walls recedes to a calmer level, and the needle on the gauge swings back down to zero..

>put towel on wheel
You can't see any such thing.

>purloin towel
[Purloined.]

>put towel on wheel
You drape the towel over the wheel.

>turn wheel
You grip the sides of the wheel -- even through the towel, you can feel the heat radiating from it -- and haul it clockwise with all your strength. It squeaks reluctantly at first, then gives all at once. From down the corridor you hear an enormous hissing rush as steam is vented from the pipes, and the needle in the gauge drops abruptly down to zero..

* * *

>z
Time passes.

You hear a heavy clunking sound from within the hatch.

>open hatch
With a sharp tug, the heavy metal door swings open.

>n
Mill Floor
Waves of heat and noise assault you from every corner. Towering above you on all sides are the enormous vats, presses and sundry machinery, the ever-churning inner workings of the paper mill. An opening in the base of the south wall leads back to the maintenance crawlway, and narrow aisles lead in several other directions through the chugging machinery. A grilled catwalk high over your head provides a more direct route across the factory; however, you see no way to get up there from here.

Bolted to the side of one of the machines is a steel ladder, leading up.

>u
The chain is too greasy for you to get a good grip on it.

* * *

Informhead
An Interactive Fiction by Ed Peters
Release 1 / Serial number 230628 / Inform 7 v10.1.2 / D

Outside the Real Estate Office
A grim little cul-de-sac, tucked away in a corner of the claustrophobic tangle of narrow, twisting avenues that largely constitute the older portion of Anchorhead. Like most of the streets in this city, it is ancient, shadowy, and leads essentially nowhere. The lane ends here at the real estate agent's office, which lies to the east, and winds its way back toward the center of town to the west. A narrow, garbage-choked alley opens to the southeast.

>w. w. w. n. w. sw. search bushes.
Narrow Street
As the lane winds along from east to west, it narrows until the steep, jagged rooftops on either side of the street practically touch each other. To the south, a side street leads across Whateley Bridge toward the center of town, and a twisting lane leads up a hill to the northwest. A short flight of steps to the north leads down to the local watering hole.

Junction
To the north, a gap in the crowded press of gloomy buildings opens onto a country lane, heading out over a grassy heath. The main street continues to the east, while to the northwest, over the top of a steep rise, you can just make out the vaulted rooftops of the university.

The street goes east and northwest, or you can take the road out of town to the north.

Mill Road
The road carries you across a desolate heath of gray, windswept grass. To the south, the black, jagged outline of Anchorhead's steep roofs and sharp, leaning gables cuts across the horizon. The road forks here to the west and east, heading across the railroad tracks in one direction, out toward the seashore in the other.

As you cross the railroad tracks, the air becomes warmer, more dingy, and slightly more difficult to breathe.

Entrance to the Paper Mill
The road turns southwest here and runs squarely through the front entrance to the old paper mill. A gate of heavy iron bars blocks the only opening into this charred fortress, although an overgrown path leads around the wall to the south. To the north, a rutted lane threads its way past a row of dilapidated shacks.

The road goes north and east from here. The mill gate lies southwest, and an overgrown trail leads south.

You can't see any such thing.

* * *

Informhead
An Interactive Fiction by Ed Peters
Release 1 / Serial number 230628 / Inform 7 v10.1.2 / D

Outside the Real Estate Office
A grim little cul-de-sac, tucked away in a corner of the claustrophobic tangle of narrow, twisting avenues that largely constitute the older portion of Anchorhead. Like most of the streets in this city, it is ancient, shadowy, and leads essentially nowhere. The lane ends here at the real estate agent's office, which lies to the east, and winds its way back toward the center of town to the west. A narrow, garbage-choked alley opens to the southeast.

>w. w. w. n. w. w.
Narrow Street
As the lane winds along from east to west, it narrows until the steep, jagged rooftops on either side of the street practically touch each other. To the south, a side street leads across Whateley Bridge toward the center of town, and a twisting lane leads up a hill to the northwest. A short flight of steps to the north leads down to the local watering hole.

Junction
To the north, a gap in the crowded press of gloomy buildings opens onto a country lane, heading out over a grassy heath. The main street continues to the east, while to the northwest, over the top of a steep rise, you can just make out the vaulted rooftops of the university.

The street goes east and northwest, or you can take the road out of town to the north.

Mill Road
The road carries you across a desolate heath of gray, windswept grass. To the south, the black, jagged outline of Anchorhead's steep roofs and sharp, leaning gables cuts across the horizon. The road forks here to the west and east, heading across the railroad tracks in one direction, out toward the seashore in the other.

As you cross the railroad tracks, the air becomes warmer, more dingy, and slightly more difficult to breathe.

Entrance to the Paper Mill
The road turns southwest here and runs squarely through the front entrance to the old paper mill. A gate of heavy iron bars blocks the only opening into this charred fortress, although an overgrown path leads around the wall to the south. To the north, a rutted lane threads its way past a row of dilapidated shacks.

The road goes north and east from here. The mill gate lies southwest, and an overgrown trail leads south.

>s.
The path curves southwest, leading you into an overgrown area behind the mill.

The path curves southwest, leading you into an overgrown area behind the mill.

Bare Foundations
The foundations of an older structure lie crumbling in a sunken square of ground, hidden away behind the imposing shadow of the mill wall. Weeds push up through cracked and buckling slabs of concrete; twisted rebar and rusting pipes poke up like the legs of dead insects. The ruins are surrounded on all sides by dense thickets, although narrow, overgrown trails lead northeast and southeast through the underbrush.

>search brush
Carefully pushing the prickly branches aside, you find a rusty metal hatch set into the base of the wall.

>purloin long steel key
[Purloined.]

* * *

>purloin light
[Purloined.]

>turn it lon
I only understood you as far as wanting to turn the flashlight.

>turn on light
You switch the flashlight on.

>unlock hatch
(with the long steel key)
You unlock the mill hatch.

>open it
You open the mill hatch.

>d
The thickets are too dense in that direction.

>l
Bare Foundations
The foundations of an older structure lie crumbling in a sunken square of ground, hidden away behind the imposing shadow of the mill wall. Weeds push up through cracked and buckling slabs of concrete; twisted rebar and rusting pipes poke up like the legs of dead insects. The ruins are surrounded on all sides by dense thickets, although narrow, overgrown trails lead northeast and southeast through the underbrush

Set into the base of the mill wall, nearly covered by the thickets, is a metal hatch.

>n
The thickets are too dense in that direction.

* * *

Informhead
An Interactive Fiction by Ed Peters
Release 1 / Serial number 230628 / Inform 7 v10.1.2 / D

Outside the Real Estate Office
A grim little cul-de-sac, tucked away in a corner of the claustrophobic tangle of narrow, twisting avenues that largely constitute the older portion of Anchorhead. Like most of the streets in this city, it is ancient, shadowy, and leads essentially nowhere. The lane ends here at the real estate agent's office, which lies to the east, and winds its way back toward the center of town to the west. A narrow, garbage-choked alley opens to the southeast.

>w. w. w. nw. n. ring bell. purloin card. show card to librarian. ask librarian about horne.
Narrow Street
As the lane winds along from east to west, it narrows until the steep, jagged rooftops on either side of the street practically touch each other. To the south, a side street leads across Whateley Bridge toward the center of town, and a twisting lane leads up a hill to the northwest. A short flight of steps to the north leads down to the local watering hole.

Junction
To the north, a gap in the crowded press of gloomy buildings opens onto a country lane, heading out over a grassy heath. The main street continues to the east, while to the northwest, over the top of a steep rise, you can just make out the vaulted rooftops of the university.

The street goes east and northwest, or you can take the road out of town to the north.

University Court
Isolated and serene within its high, ivy-covered walls, Miskaton University represents this benighted town's single, if somewhat dubious, claim to cultural achievement. Founded some time in the early 1800s, the school's reputation and enrollment have diminished somewhat as Anchorhead drifts further and further into the abyss of provincial backwaterism. Still, it is generally recognized for its collection of folklore and esoteric mythology (one of the oldest and most extensive on the east coast). The Board of Deans was also kind enough to offer Michael a full professorship upon hearing of his recently discovered heritage and his plans to move into the estate. Ivory tower, perhaps, but at least they take care of their own.

There are numerous buildings surrounding this cobbled court, but the only one you are interested in is the library to the west, where Michael told you he'd be until he came back to the real estate agent's office to pick you up. Which, incidentally, he has not yet done.

Although these hallowed halls of learning probably hold a veritable trove of knowledge, you are no longer a student, and the only building you have any business in is the library.

You can't see any such thing.

>n
Although these hallowed halls of learning probably hold a veritable trove of knowledge, you are no longer a student, and the only building you have any business in is the library.

>w
University Library
Shadows roost thickly in the vaulted ceiling, and small, green-shaded desk lamps cast pools of warm radiance here and there around the library's dim interior. You pause a moment to let the hushed peacefulness of this place soak in -- a welcome relief from the unsettling events of the day. An exit lies east, and a small alcove to the north houses the circulation counter.

Peering through the shadows, you spot your husband sitting at one of the reading desks, absorbed in some sort of weighty tome and clearly oblivious to the time.

Michael turns to a new page in the book and begins reading intently.

* * *

>ring bell
Ding!

A moment later, the gaunt and fishy-eyed librarian emerges silently from the shadows behind the counter.

>ask librarian about horne
The librarian says nothing. Slowly, very slowly, she looks you up and down, and then, just as slowly, she turns to look at the sign posted over the counter. Finally, agonizingly slowly, she turns back to you, and stares at you with a vague, unblinking air of disapproval.

>purloin card
[Purloined.]

>show card to librarian
The librarian looks the card over, nods slowly, and hands it back to you without a word.

>ask librarian about horne
horne vs Lord Wheldrake.
horne vs Warner Greene.
horne vs C. C. H. Horne.
Wordlessly the librarian retreats back into the shadows, only to reappear the next moment carrying the thick, dusty tome you saw your husband with earlier. Dutifully, you sign the register, and the librarian hands you the book before disappearing again.

>ring bell
Ding!

A moment later, the gaunt and fishy-eyed librarian emerges silently from the shadows behind the counter.

>give horne to librarian
Wordlessly the librarian takes the tome from you and spirits it back to the shadowy depths of the reserved stacks.

>ring bell
Ding!

A moment later, the gaunt and fishy-eyed librarian emerges silently from the shadows behind the counter.

>ask librarian about frazer
frazer vs Lord Wheldrake.
frazer vs Warner Greene.
frazer vs C. C. H. Horne.
frazer vs J. Arnsworth Frazer.
Wordlessly the librarian retreats back into the shadows, only to reappear the next moment carrying the thick, dusty tome you saw your husband with earlier. Dutifully, you sign the register, and the librarian hands you the book before disappearing again.

[Your score has just gone up by two points.]

>ring bell
Ding!

A moment later, the gaunt and fishy-eyed librarian emerges silently from the shadows behind the counter.

>give frazer to librarian
Wordlessly the librarian takes the tome from you and spirits it back to the shadowy depths of the reserved stacks.

* * *

Informhead
An Interactive Fiction by Ed Peters
Release 1 / Serial number 230628 / Inform 7 v10.1.2 / D

Outside the Real Estate Office
A grim little cul-de-sac, tucked away in a corner of the claustrophobic tangle of narrow, twisting avenues that largely constitute the older portion of Anchorhead. Like most of the streets in this city, it is ancient, shadowy, and leads essentially nowhere. The lane ends here at the real estate agent's office, which lies to the east, and winds its way back toward the center of town to the west. A narrow, garbage-choked alley opens to the southeast.

>w. w. w. nw. w. n.
Narrow Street
As the lane winds along from east to west, it narrows until the steep, jagged rooftops on either side of the street practically touch each other. To the south, a side street leads across Whateley Bridge toward the center of town, and a twisting lane leads up a hill to the northwest. A short flight of steps to the north leads down to the local watering hole.

Junction
To the north, a gap in the crowded press of gloomy buildings opens onto a country lane, heading out over a grassy heath. The main street continues to the east, while to the northwest, over the top of a steep rise, you can just make out the vaulted rooftops of the university.

The street goes east and northwest, or you can take the road out of town to the north.

University Court
Isolated and serene within its high, ivy-covered walls, Miskaton University represents this benighted town's single, if somewhat dubious, claim to cultural achievement. Founded some time in the early 1800s, the school's reputation and enrollment have diminished somewhat as Anchorhead drifts further and further into the abyss of provincial backwaterism. Still, it is generally recognized for its collection of folklore and esoteric mythology (one of the oldest and most extensive on the east coast). The Board of Deans was also kind enough to offer Michael a full professorship upon hearing of his recently discovered heritage and his plans to move into the estate. Ivory tower, perhaps, but at least they take care of their own.

There are numerous buildings surrounding this cobbled court, but the only one you are interested in is the library to the west, where Michael told you he'd be until he came back to the real estate agent's office to pick you up. Which, incidentally, he has not yet done.

University Library
Shadows roost thickly in the vaulted ceiling, and small, green-shaded desk lamps cast pools of warm radiance here and there around the library's dim interior. You pause a moment to let the hushed peacefulness of this place soak in -- a welcome relief from the unsettling events of the day. An exit lies east, and a small alcove to the north houses the circulation counter.

Peering through the shadows, you spot your husband sitting at one of the reading desks, absorbed in some sort of weighty tome and clearly oblivious to the time.

Michael turns to a new page in the book and begins reading intently.

Circulation Desk
A high counter divides the public portion of the library from the reserved stacks -- all the more esoteric and mysterious volumes from the university's collection. If anything, the area behind the counter is even more shadowy than the side you're on. The main reading area lies south.

Hanging on the wall next to the counter is a small, printed sign. Beneath the sign sits a heavy, dog-eared register, and sitting next to the register is a bell.

>ring bell
Ding!

A moment later, the gaunt and fishy-eyed librarian emerges silently from the shadows behind the counter.

>ask librarian about greene
The librarian says nothing. Slowly, very slowly, she looks you up and down, and then, just as slowly, she turns to look at the sign posted over the counter. Finally, agonizingly slowly, she turns back to you, and stares at you with a vague, unblinking air of disapproval.

>purloin card
[Purloined.]

* * *

>show card to librarian
The librarian looks the card over, nods slowly, and hands it back to you without a word.

>ask librarian about greene
Wordlessly the librarian retreats back into the shadows, only to reappear the next moment carrying the thick, dusty tome you saw your husband with earlier. Dutifully, you sign the register, and the librarian hands you the book before disappearing again.

>i
You are wearing your clothes, your trenchcoat and your wedding ring.

In addition, you are holding The Righteous Invasion: a History of Indian/Settler Conflicts in the Colonial Period, by Warner Greene, Michael's faculty card, your umbrella and your keyring.

>ring bell
Ding!

A moment later, the gaunt and fishy-eyed librarian emerges silently from the shadows behind the counter.

* * *

>ask librarian about horne
The librarian says nothing. Slowly, very slowly, she looks you up and down, and then, just as slowly, she turns to look at the sign posted over the counter. Finally, agonizingly slowly, she turns back to you, and stares at you with a vague, unblinking air of disapproval.

>show card to librarian
The librarian looks the card over, nods slowly, and hands it back to you without a word.

>ask librarian about horne
The librarian gives you a fishy look. Apparently, you are only allowed one book at a time.

>give greene to librarian
Wordlessly the librarian takes the tome from you and spirits it back to the shadowy depths of the reserved stacks.

>ring bell
Ding!

A moment later, the gaunt and fishy-eyed librarian emerges silently from the shadows behind the counter.

>show card to librarian. ask librarian about horne.
The librarian looks the card over, nods slowly, and hands it back to you without a word.

The librarian just looks at you.

* * *

Informhead
An Interactive Fiction by Ed Peters
Release 1 / Serial number 230628 / Inform 7 v10.1.2 / D

Outside the Real Estate Office
A grim little cul-de-sac, tucked away in a corner of the claustrophobic tangle of narrow, twisting avenues that largely constitute the older portion of Anchorhead. Like most of the streets in this city, it is ancient, shadowy, and leads essentially nowhere. The lane ends here at the real estate agent's office, which lies to the east, and winds its way back toward the center of town to the west. A narrow, garbage-choked alley opens to the southeast.

>w. w. w. nw. w. n. ring bell.
Narrow Street
As the lane winds along from east to west, it narrows until the steep, jagged rooftops on either side of the street practically touch each other. To the south, a side street leads across Whateley Bridge toward the center of town, and a twisting lane leads up a hill to the northwest. A short flight of steps to the north leads down to the local watering hole.

Junction
To the north, a gap in the crowded press of gloomy buildings opens onto a country lane, heading out over a grassy heath. The main street continues to the east, while to the northwest, over the top of a steep rise, you can just make out the vaulted rooftops of the university.

The street goes east and northwest, or you can take the road out of town to the north.

University Court
Isolated and serene within its high, ivy-covered walls, Miskaton University represents this benighted town's single, if somewhat dubious, claim to cultural achievement. Founded some time in the early 1800s, the school's reputation and enrollment have diminished somewhat as Anchorhead drifts further and further into the abyss of provincial backwaterism. Still, it is generally recognized for its collection of folklore and esoteric mythology (one of the oldest and most extensive on the east coast). The Board of Deans was also kind enough to offer Michael a full professorship upon hearing of his recently discovered heritage and his plans to move into the estate. Ivory tower, perhaps, but at least they take care of their own.

There are numerous buildings surrounding this cobbled court, but the only one you are interested in is the library to the west, where Michael told you he'd be until he came back to the real estate agent's office to pick you up. Which, incidentally, he has not yet done.

University Library
Shadows roost thickly in the vaulted ceiling, and small, green-shaded desk lamps cast pools of warm radiance here and there around the library's dim interior. You pause a moment to let the hushed peacefulness of this place soak in -- a welcome relief from the unsettling events of the day. An exit lies east, and a small alcove to the north houses the circulation counter.

Peering through the shadows, you spot your husband sitting at one of the reading desks, absorbed in some sort of weighty tome and clearly oblivious to the time.

Circulation Desk
A high counter divides the public portion of the library from the reserved stacks -- all the more esoteric and mysterious volumes from the university's collection. If anything, the area behind the counter is even more shadowy than the side you're on. The main reading area lies south.

Hanging on the wall next to the counter is a small, printed sign. Beneath the sign sits a heavy, dog-eared register, and sitting next to the register is a bell.

Ding!

A moment later, the gaunt and fishy-eyed librarian emerges silently from the shadows behind the counter.

>ask librarian about greene
The librarian says nothing. Slowly, very slowly, she looks you up and down, and then, just as slowly, she turns to look at the sign posted over the counter. Finally, agonizingly slowly, she turns back to you, and stares at you with a vague, unblinking air of disapproval.

* * *

>i
You are wearing your clothes, your trenchcoat and your wedding ring.

In addition, you are holding The Righteous Invasion: a History of Indian/Settler Conflicts in the Colonial Period, by Warner Greene, Michael's faculty card, your umbrella and your keyring.

>x greene
Its full title is The Righteous Invasion: a History of Indian/Settler Conflicts in the Colonial Period by Warner Greene. It's a slim volume, published by Miskaton Press in 1943.

>read it
According to the introduction, the book's purpose is to give an objective account of the social and economic factors which led some of the early American colonies into violent conflict with the tribes of the northeast, concluding with a transitional discussion of how the "Indian policies" which took shape early on evolved into Western Expansionism and the idea of Manifest Destiny. The author, reflecting the more conservative decade in which he wrote, tends to paint a more sympathetic picture of the European side of the issue than would be fashionable today; but all in all it seems an intelligent, thoughtful analysis.

Glancing through the table of contents, you notice that there is a short chapter on the Misquat Indians. Curious, you flip to the page.

The fate of the Misquat tribe, states the author, is an enigma which may never be solved. Diplomatic relationships with the original river valley settlers seemed doomed from the beginning. Documents from the period paint the tribe as aggressively pagan, degenerate savages. Nevertheless, Croseus Verlac managed to hammer out a peace treaty of sorts with the tribal leader, and the two groups led an uneasy coexistence for over a century.

The exact circumstances which led up to the "battle" of Quattac Bend in 1772 are unclear. One document makes mention of an "uprising", although since as far as is known, the Misquats were never in a subservient relationship to the Anchorhead settlers, the use of this term is more puzzling than revealing. In fact, no evidence has yet been discovered that corroborates the notion that the Misquat Indians initiated any sort of hostility whatsoever.

What is known is this: the Battle of Quattac Bend took place in the dead of night. It was led by Croseus" descendant, Heinrich Verlac, and "fought" by some twenty town men, who crept through the woods and ambushed the small tribe during one of its holy ceremonies. There are no lists of casualties. Although the diary of one soldier tells of many prisoners being taken, there is no mention of where these prisoners were kept or what was eventually done to them.

No known document makes even the vaguest allusion to the Misquat Indians after 1772. From that date onward, the tribe effectively ceases to exist.

>s
University Library
Shadows roost thickly in the vaulted ceiling, and small, green-shaded desk lamps cast pools of warm radiance here and there around the library's dim interior. You pause a moment to let the hushed peacefulness of this place soak in -- a welcome relief from the unsettling events of the day. An exit lies east, and a small alcove to the north houses the circulation counter.

Peering through the shadows, you spot your husband sitting at one of the reading desks, absorbed in some sort of weighty tome and clearly oblivious to the time.

>e
You're not allowed to leave the library with the book.

>n
Circulation Desk
A high counter divides the public portion of the library from the reserved stacks -- all the more esoteric and mysterious volumes from the university's collection. If anything, the area behind the counter is even more shadowy than the side you're on. The main reading area lies south.

Hanging on the wall next to the counter is a small, printed sign. Beneath the sign sits a heavy, dog-eared register, and sitting next to the register is a bell.

* * *

>ring bell
Ding!

A moment later, the gaunt and fishy-eyed librarian emerges silently from the shadows behind the counter.

>give greene to librarian
Wordlessly the librarian takes the tome from you and spirits it back to the shadowy depths of the reserved stacks.

>i
You are wearing your clothes, your trenchcoat and your wedding ring.

In addition, you are holding Michael's faculty card, your umbrella and your keyring.

* * *

>purloin card
[Purloined.]

* * *

>show card to librarian
The librarian looks the card over, nods slowly, and hands it back to you without a word.

>ask librarian about greene
*** Run-time problem P29: Attempt to see if a snippet of text matches something which is not a topic.

The librarian just looks at you.