The oldest and strongest emotion of mankind
is fear, and the oldest and strongest kind of
fear is fear of the unknown.

-- H.P. Lovecraft
                                                                                                                                                                                                                                                  I N F O R M H E A D

Please press SPACE to continue.

>consult files about wilhelm
You can't see any such thing.

>consult records about wilhelm
The records don't seem to contain anything about wilhelm.

* * *

The oldest and strongest emotion of mankind
is fear, and the oldest and strongest kind of
fear is fear of the unknown.

-- H.P. Lovecraft
                                                                                                                                                                                                                                                  I N F O R M H E A D

Please press SPACE to continue.

>consult records about heinrich
heinrich -- wilhelm.
heinrich -- heinrich.
heinrich -- elijah.
heinrich -- mordecai.
heinrich -- edward.
The records don't seem to contain anything about heinrich.

>consult records about booby
booby -- wilhelm.
booby -- heinrich.
booby -- elijah.
booby -- mordecai.
booby -- edward.
The records don't seem to contain anything about booby.

>consult records about verlac
verlac -- wilhelm.
verlac -- heinrich.
verlac -- elijah.
verlac -- mordecai.
verlac -- edward.
There are dozens of Verlacs in the files; try using a first name instead

>consult records about wil
wil -- wilhelm.
wil -- heinrich.
wil -- elijah.
wil -- mordecai.
wil -- edward.
The records don't seem to contain anything about wil.

* * *

The oldest and strongest emotion of mankind
is fear, and the oldest and strongest kind of
fear is fear of the unknown.

-- H.P. Lovecraft
                                                                                                                                                                                                                                                  I N F O R M H E A D

Please press SPACE to continue.

>consult records about wilhelm
Wilhelm Verlac: born March 11, 1651

>consult records about Wilhelm
Wilhelm Verlac: born March 11, 1651..

>consult records about Wilhelm Verlac
The records don't seem to contain anything about Wilhelm Verlac.

>look up Wilhelm
I only understood you as far as wanting to look up.

>look up wilhelm
I only understood you as far as wanting to look up.

* * *

>consult records about wilhelm
Wilhelm Verlac: born March 11, 1651

>consult records about barney
The records don't seem to contain anything about barney.

* * *

>consult records about wilhelm
Wilhelm Verlac: born March 11, 1651

>consult records about edward
Edward Verlac: born April 26, 1960

>consult records about elijah
Elijah Verlac: born December 16, 1802

>nw. se.
Courthouse Basement
A single bulb dangling from the ceiling casts a watery, yellow light against the brick walls. A rickety staircase to the north leads back up to the ground floor, and two narrow doorways lead into the record archives. Over the southeast door hangs a sign that reads "BIRTH RECORDS", while the southwest door bears the sign "DEATH RECORDS".

Birth Records
A bare room with cinderblock walls. Thousands of records and documents, most yellow and brittle with age, are stacked everywhere in towering piles. The exit lies northwest.

>nw. sw.
Courthouse Basement
A single bulb dangling from the ceiling casts a watery, yellow light against the brick walls. A rickety staircase to the north leads back up to the ground floor, and two narrow doorways lead into the record archives. Over the southeast door hangs a sign that reads "BIRTH RECORDS", while the southwest door bears the sign "DEATH RECORDS".

Death Records
A bare room with cinderblock walls. Thousands of records and documents, most yellow and brittle with age, are stacked everywhere in towering piles. The exit lies northeast.

>consult records about elijah
Elijah Verlac: died January 30, 1886

>consult records about edward
Edward Verlac: died March 14, 1997

>consult records about wilhelm
Wilhelm Verlac: died October 18, 1734

You seem to be uncovering a pattern here; all these Verlacs seem to have lived to a ripe old age and then died on the very day the next one is born. The birth records are incomplete -- no parents are listed, and no cause of death is noted on the death records -- there's just not enough information here to draw a conclusion. You'll simply have to keep digging until you find the answers...

>consult records about edward
Edward Verlac: died March 14, 1997

* * *

>consult records about wilhelm
Wilhelm Verlac: born March 11, 1651

>consult records about heinrich
Heinrich Verlac: died December 16, 1802.

>consult records about mordecai
Mordecai Verlac: died April 26, 1960.

>showme player
There seems to be no such object anywhere in the model world.

>showme self
yourself - person
    A Historical Overview of Superstitions by J. Arnsworth Frazer
    clothes (worn)
    trenchcoat (worn)
    wedding ring (worn)
    umbrella
    keyring - open container
location: in Death Records
unlit, inedible, portable; transparent, male; singular-named, proper-named
description: "As good-looking as ever."
initial appearance: none
last turn examined: -2
printing: "blank"
carrying capacity: 100
printed name: "yourself"
printed plural name: "people"
indefinite article: none
list grouping key: none
day: 1
spider: 0
births: 3
deaths: 0

* * *

>consult records about wilhelm
Wilhelm Verlac: born March 11, 1651

>consult records about w
The records don't seem to contain anything about w.

>consult records about wwwwwww
The records don't seem to contain anything about wwwwwww.

>consult records about Wilhelm Verlac
There are dozens of Verlacs in the files; try using a first name instead.

>consult records about "Wilhelm Verlac
The records don't seem to contain anything about "Wilhelm Verlac?.

>consult records about 'Wilhelm Verlac
The records don't seem to contain anything about 'Wilhelm Verlac?.

>consult records about ?@?!
The records don't seem to contain anything about ?@?!.

* * *

>consult records about wilhelm
Wilhelm Verlac: born March 11, 1651

>consult records about wil
wil -- wilhelm.
wil -- heinrich.
wil -- elijah.
wil -- mordecai.
wil -- edward.
The records don't seem to contain anything about wil.

* * *

>consult records about wilhelm
Wilhelm Verlac: born March 11, 1651

>consult records about wilhelm verlac
The records don't seem to contain anything about wilhelm verlac.

>consult records about wilhelm verlac
The records don't seem to contain anything about ?wilhelm verlac?.

>consult records about verlac
There are dozens of Verlacs listed here; you'll have to be more specific than that.

>consult records about verlac
There are dozens of Verlacs listed here; you'll have to be more specific than that.

* * *

The oldest and strongest emotion of mankind
is fear, and the oldest and strongest kind of
fear is fear of the unknown.

-- H.P. Lovecraft
                                                                                                                                                                                                                                                  I N F O R M H E A D

Please press SPACE to continue.

>d
Foyer
Although it appears spacious from the outside, the house's interior feels cramped and gloomy. The walls seem too close together; the ceiling is too high. The doorways, leading in several directions, are narrow and filled with shadows, and the stairs leading up to the second floor are steep and rickety. This is not a house that makes you feel welcome. It is a house that makes you feel tiny and timid, and afraid of dark places. It is a house that makes you feel alone.

Carelessly stacked in a towering heap in the middle of the room are all your luggage and belongings, which you had sent ahead through a moving company before driving up to Massachusetts. Everything you own is boxed away and piled up in the middle of the floor. The reality of this move finally slams home as you stare at the sprawling jumble of stuff, and suddenly you feel very lost and adrift.

Night has now undeniably fallen, and the house is very, very dark. There is probably just enough residual ambience to feel your way upstairs to the bedroom, but the rest of the house is a tenebrous maze of shadows, and any exploring would probably best be done in the morning.

I beg your pardon?

>w
Dining Room
Much of the elegance has faded from this room. The huge dining table running the length of it is covered with a thick gray film of dust, and the china cupboard standing against the far wall is draped in shadow. Doorways to the north and east offer little relief from the gloom. For what must be the hundredth time, you wish you could open the windows in this place.

It's a free-standing cabinet about as tall as you are, crafted of cherrywood. The double paneled doors are closed.

>n
Kitchen
Where once pots and skillets and various utensils hung in profusion, the kitchen walls are now merely ranks of dusty cabinets and a forest of empty hooks. Doorways lead east and south, a small pantry lies to the northwest, and the back door to the north leads out of the house.

An odd feeling of gloom overtakes you momentarily, and you find yourself thinking about the Verlac family's personal effects -- the everyday mundanities, such as kitchen utensils. Were they thrown out, or donated to charity, or auctioned off as grisly souvenirs? What about the canned goods? Did anyone think to take them? The cabinets might even still be stocked. Morbidly, you wonder what Mrs. Edward Verlac might have been cooking for dinner the night her husband blew her head off.

Someone's flashlight is lying on the kitchen counter; one of the movers must have left it.

>nw
Darkness
It is pitch dark, and you can't see a thing.

>se
You can't go that way.

>s
You can't go that way.

>se
You can't go that way.

>e
You can't go that way.

>sw
You can't go that way.

* * *

>l
Foyer
Although it appears spacious from the outside, the house's interior feels cramped and gloomy. The walls seem too close together; the ceiling is too high. The doorways, leading in several directions, are narrow and filled with shadows, and the stairs leading up to the second floor are steep and rickety. This is not a house that makes you feel welcome. It is a house that makes you feel tiny and timid, and afraid of dark places. It is a house that makes you feel alone.

Your luggage is still here, spread out all over the foyer.

>open front door
(first unlocking the front door)

>s
(first opening the front door)
(first unlocking the front door)

>l
Foyer
Although it appears spacious from the outside, the house's interior feels cramped and gloomy. The walls seem too close together; the ceiling is too high. The doorways, leading in several directions, are narrow and filled with shadows, and the stairs leading up to the second floor are steep and rickety. This is not a house that makes you feel welcome. It is a house that makes you feel tiny and timid, and afraid of dark places. It is a house that makes you feel alone.

Your luggage is still here, spread out all over the foyer.

>n
Darkness
It is pitch dark, and you can't see a thing.

* * *

>n
Back Hall
A short hallway, connecting rooms to the east, west and south.

>e
You can't go that way.

>s
Foyer
Although it appears spacious from the outside, the house's interior feels cramped and gloomy. The walls seem too close together; the ceiling is too high. The doorways, leading in several directions, are narrow and filled with shadows, and the stairs leading up to the second floor are steep and rickety. This is not a house that makes you feel welcome. It is a house that makes you feel tiny and timid, and afraid of dark places. It is a house that makes you feel alone.

Your luggage is still here, spread out all over the foyer.

>e
Sitting Room
The east wall is occupied by a beautiful antique sofa, and a large, hand-woven rug covers the hardwood floor. The huge marble fireplace in the north wall helps complete the impression of comfort and warmth, and for a moment or two you can almost think of this place as somewhere you could live, as opposed to merely somewhere others have died. The foyer lies west, and a doorway to the left of the fireplace leads north.

Your brief sense of comfort quickly drains away, however, as you become aware of the icy and maniacal stare emanating from the great portrait hanging over the mantelpiece. Under the malefic gaze of those red-rimmed eyes, the most comforting thought you can muster is that of immediate flight.

On the sofa is a family album.

>n
Gallery
A long, oak-paneled room, with doorways to the south and west. Paintings line the walls, mounted beneath small, shaded lamps that would illuminate the canvasses nicely if only the electricity were working. Still, even in the shadowed gloom you can see that all were done by the same artist.

>s
Sitting Room
The east wall is occupied by a beautiful antique sofa, and a large, hand-woven rug covers the hardwood floor. The huge marble fireplace in the north wall helps complete the impression of comfort and warmth, and for a moment or two you can almost think of this place as somewhere you could live, as opposed to merely somewhere others have died. The foyer lies west, and a doorway to the left of the fireplace leads north.

The portrait gazes down at you with crimson-edged malice.

On the sofa is a family album.

>w
Foyer
Although it appears spacious from the outside, the house's interior feels cramped and gloomy. The walls seem too close together; the ceiling is too high. The doorways, leading in several directions, are narrow and filled with shadows, and the stairs leading up to the second floor are steep and rickety. This is not a house that makes you feel welcome. It is a house that makes you feel tiny and timid, and afraid of dark places. It is a house that makes you feel alone.

Your luggage is still here, spread out all over the foyer.

>w
You can't go that way.

* * *

>n
Back Hall
A short hallway, connecting rooms to the east, west and south.

>w
Kitchen
Where once pots and skillets and various utensils hung in profusion, the kitchen walls are now merely ranks of dusty cabinets and a forest of empty hooks. Doorways lead east and south, a small pantry lies to the northwest, and the back door to the north leads out of the house.

An odd feeling of gloom overtakes you momentarily, and you find yourself thinking about the Verlac family's personal effects -- the everyday mundanities, such as kitchen utensils. Were they thrown out, or donated to charity, or auctioned off as grisly souvenirs? What about the canned goods? Did anyone think to take them? The cabinets might even still be stocked. Morbidly, you wonder what Mrs. Edward Verlac might have been cooking for dinner the night her husband blew her head off.

Someone's flashlight is lying on the kitchen counter; one of the movers must have left it.

>l
Kitchen
Where once pots and skillets and various utensils hung in profusion, the kitchen walls are now merely ranks of dusty cabinets and a forest of empty hooks. Doorways lead east and south, a small pantry lies to the northwest, and the back door to the north leads out of the house.

Someone's flashlight is lying on the kitchen counter; one of the movers must have left it.

>x cabinet
You see nothing special about the kitchen cabinet.

>open cabinet
The cabinets are not, after all, still stocked -- much to your relief. There's nothing in there but an old book of matches.

You open the kitchen cabinet, revealing a matches.

>x it
In the kitchen cabinet is a matches.

* * *

>x cabinet
You see nothing special about the kitchen cabinet.

>open it
It isn't something you can open.

* * *

>nw
Darkness
It is pitch dark, and you can't see a thing.

>se
Kitchen
Where once pots and skillets and various utensils hung in profusion, the kitchen walls are now merely ranks of dusty cabinets and a forest of empty hooks. Doorways lead east and south, a small pantry lies to the northwest, and the back door to the north leads out of the house.

Someone's flashlight is lying on the kitchen counter; one of the movers must have left it.

>take light
Taken.

>turn it on
You switch the flashlight on.

>nw
Pantry
The pantry is empty save for a layer of dust on the shelves. A door to the south leads down to the cellar, or you can return to the kitchen to the southeast.

Leaning in the corner is an old broom.

You can also see a cdoor here.

>open cdoor
It seems to be locked.

>unlock cdoor
Maybe you need a key for that?

>unlock cdoor with cellar key
You can't see any such thing.

>i
You are carrying:
  a flashlight (providing light)
  your clothes (being worn)
  your trenchcoat (being worn)
  your wedding ring (being worn)
  your keyring

* * *

>nw
Darkness
It is pitch dark, and you can't see a thing.

>x flight
You can't see any such thing.

>x light
You can't see any such thing.

>x flashlight
It's battery-powered, and waterproof too, by the look of it.

The flashlight is currently switched off.

>take it
Taken.

* * *

>l
Kitchen
Where once pots and skillets and various utensils hung in profusion, the kitchen walls are now merely ranks of dusty cabinets and a forest of empty hooks. Doorways lead east and south, a small pantry lies to the northwest, and the back door to the north leads out of the house.

* * *

>open cabinet
The cabinets are not, after all, still stocked -- much to your relief. There's nothing in there but an old book of matches.

You open the kitchen cabinet, revealing a matchbook.

>take matchbook
Taken.

>close cabinet
You close the kitchen cabinet.

>open cabinet
The cabinets are not, after all, still stocked -- much to your relief. There's nothing in there but an old book of matches.

You open the kitchen cabinet.

>put all in cabinet
matchbook: Done.
keyring: Done.

>close cabinet
You close the kitchen cabinet.

>open cabinet
The cabinets are not, after all, still stocked -- much to your relief. There's nothing in there but an old book of matches.

You open the kitchen cabinet, revealing a keyring and a matchbook.

* * *

>take light.
Taken.

>nw
Darkness
It is pitch dark, and you can't see a thing.

>se
Kitchen
Where once pots and skillets and various utensils hung in profusion, the kitchen walls are now merely ranks of dusty cabinets and a forest of empty hooks. Doorways lead east and south, a small pantry lies to the northwest, and the back door to the north leads out of the house.

>turn light on
You switch the flashlight on.

>nw
Pantry
The pantry is empty save for a layer of dust on the shelves. A door to the south leads down to the cellar, or you can return to the kitchen to the southeast.

Leaning in the corner is an old broom.

>x shelves
You see nothing special about the shelves.

* * *

>x cabinet
You can't see inside, since the cabinet is closed.

>open it
The cabinets are not, after all, still stocked -- much to your relief. There's nothing in there but an old book of matches.

You open the kitchen cabinet, revealing a matchbook.

>showme cabinet
(the kitchen cabinet)
kitchen cabinet - open container
    matchbook
location: in Kitchen
unlit, inedible, fixed in place, scenery; opaque, open, openable, unlocked; singular-named, improper-named
description: none
initial appearance: none
printing: "blank"
carrying capacity: 100
printed name: "kitchen cabinet"
printed plural name: "containers"
indefinite article: none
list grouping key: none

* * *

>open it
The cabinets are not, after all, still stocked -- much to your relief. There's nothing in there but an old book of matches.

You open the kitchen cabinet, revealing a matchbook.

>x cabinet
The cabinet contains matchbook.

In the kitchen cabinet is a matchbook.

* * *

>open it
The cabinets are not, after all, still stocked -- much to your relief. There's nothing in there but an old book of matches.

You open the kitchen cabinet, revealing a matchbook.

>x it
In the kitchen cabinet is a matchbook.

* * *

>test dining
(Testing.)

>[1] w

Dining Room
Much of the elegance has faded from this room. The huge dining table running the length of it is covered with a thick gray film of dust, and the china cupboard standing against the far wall is draped in shadow. Doorways to the north and east offer little relief from the gloom. For what must be the hundredth time, you wish you could open the windows in this place.

It's a free-standing cabinet about as tall as you are, crafted of cherrywood. The double paneled doors are closed.

>[2] x table
It's a finely built table, a valued antique like much of the furniture in this house. It will need to be oiled after so many months of neglect, though.

>[3] put keyring on table
You put the keyring on the dinner table.

>[4] take keyring
Taken.

>[5] x cupboard
You see nothing special about the cupboard.

>[6] open it
The cupboard is empty; the china must have been auctioned off, in the confusion before Michael was contacted, perhaps. Down at the bottom of the cupboard is a velvet lining, where the silverware would usually be kept.

You open the cupboard, revealing nothing.

>[7] x velvet
The lining is soft, dusky burgundy. One corner in back is pulled up a bit and slightly torn.

>[8] pull it
You pull the lining back a bit further and discover a thin, palm-sized journal tucked underneath it. Intrigued, you pull the little book free.

[Your score has just gone up by two points.]

>i
You are carrying:
  a torn journal
  a keyring
  your clothes (being worn)
  your trenchcoat (being worn)
  your wedding ring (being worn)

>x journal
It's a slim little book, no bigger than your hand, bound in imitation leather. The mice really have been at it; most of the pages have been chewed away.

>read it
It's a slim little book, no bigger than your hand, bound in imitation leather. The mice really have been at it; most of the pages have been chewed away. What's left of the journal reads:

Desperate. Went back to the old twisting lane and found only a blank wall. Without the amulet, how can I resist --

...bottles, bottles...

Getting worse. People I have never met smile knowingly at me in the street. The police believe I am a child molester, but have brought no charges against me as yet. Why? Head hurts all the time. I have turned the cellar upside-down... damn it all, where is it?

Dreamed of Father again. Dreamed of Grandfather. Those horrible, red-rimmed eyes...

-- into the safe, finally. 30-2-8. Won't forget THAT soon. Ha!

CANNOT DISCOVER ENTRANCE IN THE CELLAR!!! Secret eludes me still but I WILL FIND IT!!! The clue is in their names, that pestilential procession of names! If I could only -- 

The text breaks off as several more pages are missing. the last fragmented entry reads:

 -- will fail. There is no recourse left. I know now what I must do. Julia --

* * *

>test sitting
(Testing.)

>[1] e

Sitting Room
The east wall is occupied by a beautiful antique sofa, and a large, hand-woven rug covers the hardwood floor. The huge marble fireplace in the north wall helps complete the impression of comfort and warmth, and for a moment or two you can almost think of this place as somewhere you could live, as opposed to merely somewhere others have died. The foyer lies west, and a doorway to the left of the fireplace leads north.

Your brief sense of comfort quickly drains away, however, as you become aware of the icy and maniacal stare emanating from the great portrait hanging over the mantelpiece. Under the malefic gaze of those red-rimmed eyes, the most comforting thought you can muster is that of immediate flight.

On the sofa is a family album.

>[2] x sofa
It's a 19th century William IV-style sofa with wide, flaring armrests and beautifully scrolled mahogany woodwork. The upholstery is a soft, faded wine color.

>[3] x fireplace
The fireplace is carved from beautiful, dark-veined marble, a strange shade that is not quite a deep, forest green and not quite a murky, dusky red.

>[4] x painting
The man in the portrait is the apotheosis of everything cruel and inhuman that you have ever laid eyes on. His archaic Puritan dress would indicate that he must have lived a very long time ago; perhaps he was the founder of the Verlac family in this region. If so, it's no wonder they all wound up murdered or mad: the red-rimmed eyes glaring down from his gaunt and haggard face seem to blaze with a terrible insanity. There is nothing regal, fatherly or dignified about this portrait. It is the essence of raving, gibbering evil captured on canvas.

>w
Foyer
Although it appears spacious from the outside, the house's interior feels cramped and gloomy. The walls seem too close together; the ceiling is too high. The doorways, leading in several directions, are narrow and filled with shadows, and the stairs leading up to the second floor are steep and rickety. This is not a house that makes you feel welcome. It is a house that makes you feel tiny and timid, and afraid of dark places. It is a house that makes you feel alone.

Your luggage is still here, spread out all over the foyer.

>e
Sitting Room
The east wall is occupied by a beautiful antique sofa, and a large, hand-woven rug covers the hardwood floor. The huge marble fireplace in the north wall helps complete the impression of comfort and warmth, and for a moment or two you can almost think of this place as somewhere you could live, as opposed to merely somewhere others have died. The foyer lies west, and a doorway to the left of the fireplace leads north.

The portrait gazes down at you with crimson-edged malice.

On the sofa is a family album.

* * *

>w
Foyer
Although it appears spacious from the outside, the house's interior feels cramped and gloomy. The walls seem too close together; the ceiling is too high. The doorways, leading in several directions, are narrow and filled with shadows, and the stairs leading up to the second floor are steep and rickety. This is not a house that makes you feel welcome. It is a house that makes you feel tiny and timid, and afraid of dark places. It is a house that makes you feel alone.

Your luggage is still here, spread out all over the foyer.

>test gallery
(Testing.)

>[1] e

Sitting Room
The east wall is occupied by a beautiful antique sofa, and a large, hand-woven rug covers the hardwood floor. The huge marble fireplace in the north wall helps complete the impression of comfort and warmth, and for a moment or two you can almost think of this place as somewhere you could live, as opposed to merely somewhere others have died. The foyer lies west, and a doorway to the left of the fireplace leads north.

The portrait gazes down at you with crimson-edged malice.

On the sofa is a family album.

>[2] n

Gallery
A long, oak-paneled room, with doorways to the south and west. Paintings line the walls, mounted beneath small, shaded lamps that would illuminate the canvasses nicely if only the electricity were working. Still, even in the shadowed gloom you can see that all were done by the same artist.

>[3] x lamps
The lamps are made of polished brass, with frosted green shades -- like an old-fashioned desk lamp, only mounted on the wall.

>[4] x paintings
All of them are bizarre, and most of them border on the grotesque. Alien landscapes peopled by writhing, malformed creatures; ancient temples built in strange, eye-bending architectures; monstrous beasts crawling through shadows that cannot quite conceal their disturbingly human shapes -- these seem to make up the bulk of the paintings" subject matter. And yet, despite the fantastical nature of the images painted, the style is neither abstract nor surreal. In fact, the level of detail approaches the photorealistic. Excruciating attention has been paid to light, shadows, and textures; even the alien creatures are depicted with gruesome anatomical accuracy. It is as though the artist had worked from actual, living models rather than from what must have been a thoroughly deranged imagination, and the overall effect is rather chilling.

>w
Back Hall
A short hallway, connecting rooms to the east, west and south.

>s
Foyer
Although it appears spacious from the outside, the house's interior feels cramped and gloomy. The walls seem too close together; the ceiling is too high. The doorways, leading in several directions, are narrow and filled with shadows, and the stairs leading up to the second floor are steep and rickety. This is not a house that makes you feel welcome. It is a house that makes you feel tiny and timid, and afraid of dark places. It is a house that makes you feel alone.

Your luggage is still here, spread out all over the foyer.

>test dining
(Testing.)

>[1] w

Dining Room
Much of the elegance has faded from this room. The huge dining table running the length of it is covered with a thick gray film of dust, and the china cupboard standing against the far wall is draped in shadow. Doorways to the north and east offer little relief from the gloom. For what must be the hundredth time, you wish you could open the windows in this place.

It's a free-standing cabinet about as tall as you are, crafted of cherrywood. The double paneled doors are closed.

>[2] x table
It's a finely built table, a valued antique like much of the furniture in this house. It will need to be oiled after so many months of neglect, though.

>[3] put keyring on table
You put the keyring on the dinner table.

>[4] take keyring
Taken.

>[5] x cupboard
You see nothing special about the cupboard.

>[6] open it
The cupboard is empty; the china must have been auctioned off, in the confusion before Michael was contacted, perhaps. Down at the bottom of the cupboard is a velvet lining, where the silverware would usually be kept.

You open the cupboard, revealing nothing.

>[7] x velvet
The lining is soft, dusky burgundy. One corner in back is pulled up a bit and slightly torn.

>[8] pull it
You pull the lining back a bit further and discover a thin, palm-sized journal tucked underneath it. Intrigued, you pull the little book free.

[Your score has just gone up by two points.]

>i
You are carrying:
  a diary
  a keyring
  your clothes (being worn)
  your trenchcoat (being worn)
  your wedding ring (being worn)

* * *

>u
Darkness
It is pitch dark, and you can't see a thing.

* * *

>w
Darkness
It is pitch dark, and you can't see a thing.

>e
Foyer
Although it appears spacious from the outside, the house's interior feels cramped and gloomy. The walls seem too close together; the ceiling is too high. The doorways, leading in several directions, are narrow and filled with shadows, and the stairs leading up to the second floor are steep and rickety. This is not a house that makes you feel welcome. It is a house that makes you feel tiny and timid, and afraid of dark places. It is a house that makes you feel alone.

Your luggage is still here, spread out all over the foyer.

>n
Darkness
It is pitch dark, and you can't see a thing.

>s
Foyer
Although it appears spacious from the outside, the house's interior feels cramped and gloomy. The walls seem too close together; the ceiling is too high. The doorways, leading in several directions, are narrow and filled with shadows, and the stairs leading up to the second floor are steep and rickety. This is not a house that makes you feel welcome. It is a house that makes you feel tiny and timid, and afraid of dark places. It is a house that makes you feel alone.

Your luggage is still here, spread out all over the foyer.

>i
You are carrying:
  your clothes (being worn)
  your trenchcoat (being worn)
  your wedding ring (being worn)
  a keyring

>drop wedding ring
(first taking the wedding ring off)
Dropped.

>take it
You take the wedding ring. Staring at your wedding ring like that tends to make you sentimental.

Taken.

* * *

>e
Foyer
Although it appears spacious from the outside, the house's interior feels cramped and gloomy. The walls seem too close together; the ceiling is too high. The doorways, leading in several directions, are narrow and filled with shadows, and the stairs leading up to the second floor are steep and rickety. This is not a house that makes you feel welcome. It is a house that makes you feel tiny and timid, and afraid of dark places. It is a house that makes you feel alone.

Your luggage is still here, spread out all over the foyer.

>w
Dining Room
Much of the elegance has faded from this room. The huge dining table running the length of it is covered with a thick gray film of dust, and the china cupboard standing against the far wall is draped in shadow. Doorways to the north and east offer little relief from the gloom. For what must be the hundredth time, you wish you could open the windows in this place.

It's a free-standing cabinet about as tall as you are, crafted of cherrywood. The double paneled doors are closed.

>n
Kitchen

>e
Back Hall
A short hallway, connecting rooms to the east, west and south.

>e
Sitting Room
The east wall is occupied by a beautiful antique sofa, and a large, hand-woven rug covers the hardwood floor. The huge marble fireplace in the north wall helps complete the impression of comfort and warmth, and for a moment or two you can almost think of this place as somewhere you could live, as opposed to merely somewhere others have died. The foyer lies west, and a doorway to the left of the fireplace leads north.

Your brief sense of comfort quickly drains away, however, as you become aware of the icy and maniacal stare emanating from the great portrait hanging over the mantelpiece. Under the malefic gaze of those red-rimmed eyes, the most comforting thought you can muster is that of immediate flight.

On the sofa is a family album.

>s
You can't go that way.

>n
Gallery
A long, oak-paneled room, with doorways to the south and west. Paintings line the walls, mounted beneath small, shaded lamps that would illuminate the canvasses nicely if only the electricity were working. Still, even in the shadowed gloom you can see that all were done by the same artist.

>w
You can't go that way.

>w
You can't go that way.

>s
Sitting Room
The east wall is occupied by a beautiful antique sofa, and a large, hand-woven rug covers the hardwood floor. The huge marble fireplace in the north wall helps complete the impression of comfort and warmth, and for a moment or two you can almost think of this place as somewhere you could live, as opposed to merely somewhere others have died. The foyer lies west, and a doorway to the left of the fireplace leads north.

The portrait gazes down at you with crimson-edged malice.

On the sofa is a family album.

>w
Back Hall
A short hallway, connecting rooms to the east, west and south.

>n
You can't go that way.

>e
Sitting Room
The east wall is occupied by a beautiful antique sofa, and a large, hand-woven rug covers the hardwood floor. The huge marble fireplace in the north wall helps complete the impression of comfort and warmth, and for a moment or two you can almost think of this place as somewhere you could live, as opposed to merely somewhere others have died. The foyer lies west, and a doorway to the left of the fireplace leads north.

The portrait gazes down at you with crimson-edged malice.

On the sofa is a family album.

* * *

>w
Darkness
It is pitch dark, and you can't see a thing.

>n
Kitchen
Where once pots and skillets and various utensils hung in profusion, the kitchen walls are now merely ranks of dusty cabinets and a forest of empty hooks. Doorways lead east and south, a small pantry lies to the northwest, and the back door to the north leads out of the house.

An odd feeling of gloom overtakes you momentarily, and you find yourself thinking about the Verlac family's personal effects -- the everyday mundanities, such as kitchen utensils. Were they thrown out, or donated to charity, or auctioned off as grisly souvenirs? What about the canned goods? Did anyone think to take them? The cabinets might even still be stocked. Morbidly, you wonder what Mrs. Edward Verlac might have been cooking for dinner the night her husband blew her head off.

Someone's flashlight is lying on the kitchen counter; one of the movers must have left it.

>take flashlight
Taken.

>turn it on
You switch the flashlight on.

>i
You are carrying:
  a flashlight (providing light)
  your clothes (being worn)
  your trenchcoat (being worn)
  your wedding ring (being worn)
  a keyring

>turn off flashlight
You switch the flashlight off.

* * *

The oldest and strongest emotion of mankind
is fear, and the oldest and strongest kind of
fear is fear of the unknown.

-- H.P. Lovecraft
                                                                                                                                                                                                                                                  I N F O R M H E A D

Please press SPACE to continue.

>d. n. w.
Foyer
Although it appears spacious from the outside, the house's interior feels cramped and gloomy. The walls seem too close together; the ceiling is too high. The doorways, leading in several directions, are narrow and filled with shadows, and the stairs leading up to the second floor are steep and rickety. This is not a house that makes you feel welcome. It is a house that makes you feel tiny and timid, and afraid of dark places. It is a house that makes you feel alone.

Carelessly stacked in a towering heap in the middle of the room are all your luggage and belongings, which you had sent ahead through a moving company before driving up to Massachusetts. Everything you own is boxed away and piled up in the middle of the floor. The reality of this move finally slams home as you stare at the sprawling jumble of stuff, and suddenly you feel very lost and adrift.

Night has now undeniably fallen, and the house is very, very dark. There is probably just enough residual ambience to feel your way upstairs to the bedroom, but the rest of the house is a tenebrous maze of shadows, and any exploring would probably best be done in the morning.

Back Hall
A short hallway, connecting rooms to the east, west and south.

Kitchen
Where once pots and skillets and various utensils hung in profusion, the kitchen walls are now merely ranks of dusty cabinets and a forest of empty hooks. Doorways lead east and south, a small pantry lies to the northwest, and the back door to the north leads out of the house.

Someone's flashlight is lying on the kitchen counter; one of the movers must have left it.

>x flashlight
It's battery-powered, and waterproof too, by the look of it. The flashlight is currently switched off.

The flashlight is currently switched off.

>take it
Taken.

>turn it on
You switch the flashlight on.

>turn it off
You switch the flashlight off.

* * *

The oldest and strongest emotion of mankind
is fear, and the oldest and strongest kind of
fear is fear of the unknown.

-- H.P. Lovecraft
                                                                                                                                                                                                                                                  I N F O R M H E A D

Please press SPACE to continue.

>day 2
You wake up. Steam billows gently by, and you can hear the sound of running water coming from the bathroom.

* * *

>showme
Outside the Real Estate Office - room
    office door - locked door
    sky - backdrop
    cobblestones - backdrop
    rooftops - backdrop
    yourself - person
        A Historical Overview of Superstitions by J. Arnsworth Frazer
        clothes (worn)
        trenchcoat (worn)
        wedding ring (worn)
        umbrella
        keyring - open container

>showme player
There seems to be no such object anywhere in the model world.

>showme self
yourself - person
    A Historical Overview of Superstitions by J. Arnsworth Frazer
    clothes (worn)
    trenchcoat (worn)
    wedding ring (worn)
    umbrella
    keyring - open container
location: in Outside the Real Estate Office
unlit, inedible, portable; transparent, male; singular-named, proper-named
description: "As good-looking as ever."
initial appearance: none
last turn examined: -2
printing: "blank"
carrying capacity: 100
printed name: "yourself"
printed plural name: "people"
indefinite article: none
list grouping key: none
day: 3
spider: 0

* * *

The oldest and strongest emotion of mankind
is fear, and the oldest and strongest kind of
fear is fear of the unknown.

-- H.P. Lovecraft
                                                                                                                                                                                                                                                  I N F O R M H E A D

Please press SPACE to continue.

>day 3
You wake up, shivering. Michael is in bed next to you, sleeping like a dead man with the sheets wrapped in a twisted snarl around his body.

>restart
Are you sure you want to restart?

>yes
Informhead
An Interactive Fiction by Ed Peters
Release 1 / Serial number 230530 / Inform 7 v10.1.2 / D

Outside the Real Estate Office
A grim little cul-de-sac, tucked away in a corner of the claustrophobic tangle of narrow, twisting avenues that largely constitute the older portion of Anchorhead. Like most of the streets in this city, it is ancient, shadowy, and leads essentially nowhere. The lane ends here at the real estate agent's office, which lies to the east, and winds its way back toward the center of town to the west. A narrow, garbage-choked alley opens to the southeast.

* * *

>day 3
You wake up, shivering. Michael is in bed next to you, sleeping like a dead man with the sheets wrapped in a twisted snarl around his body.

>stand
You get off the bed.

Master Bedroom
The master bedroom is a picture-postcard of rustic New England charm. Faded sketches of rural landscapes adorn the walls; a beautifully carved dressing mirror stands in one corner; an old-fashioned accordion radiator gurgles quietly beneath the window. The most striking feature, an enormous, antique, four-poster bed, must be the largest piece of furniture in the house.

On the four-poster bed you can see Michael's pants.

You can also see your trenchcoat, your clothes, your keyring (empty), your umbrella, a house key and a cellar key here.

>take all
Michael's pants: You take Michael's pants. They're the same plain khakis he usually wears. You notice something in the back pocket..
trenchcoat: You put on the trenchcoat.
clothes: You put on the clothes.
keyring: You take the keyring. .
umbrella: You take the umbrella. It's olive green, with a hook-shaped handle. A handy little thing, when it rains. It's currently closed..
house key: You take the house key. .
cellar key: You take the cellar key. .
Michael's wallet: You take Michael's wallet. It's just his wallet, an ordinary leather wallet..

>s
Upstairs Landing
A narrow hallway runs east, from the top of the stairs down the length of the house. To the north, directly opposite the stairs, is the master bedroom.

>e
Upstairs Hall
The shuttered window at the end of the hall throws a gloomy rectangle of light onto the bare wooden floor. Doorways lead north and south.

There is a cord dangling in mid-air here, right about level with your face.

>n
You pause as the shower shuts off, and you hear Michael moving around in the next room. His footsteps thump loudly on the hardwood floor as he comes down the hall, and then are muffled again as he steps onto the deep green carpet of the library.

"Good morning," he says, smiling and kissing you lightly on the cheek. He looks around at the crowded rows of books. "Neat, huh? I may go through some of them this morning. Since the fogies don't need me to start work until tomorrow, I thought I'd stay home and try to get some writing done."

As he steps through the sliding doors into the study, he turns and says, "I'll be in here for a while, okay? Oh, and if you go out today, see if you can find a newspaper somewhere." He smiles as he slides the doors shut.

Library
Whatever else their faults may have been, the Verlacs were evidently not ones to shun the printed word. Books line the walls from floor to ceiling in this dark-paneled, green-carpeted room, interrupted only by doorways to the east and south. A rich, brown leather armchair sits in stately repose near the window, with a polished brass pipe stand nearby completing the picture of some blue-blooded country squire's literary refuge. Once again, you are struck by how easily this place could have been the perfect home.

A beautiful pair of mahogany sliding doors stand closed to the east.

Resting on the pipe stand is a sizable volume decorated with a gilded pentagram on its cover.

>e
(first opening the mahogany doors)
Michael is in the study, typing furiously at his laptop. As you walk in he looks up at you with a pained expression. "Can it wait?" he asks you. "I think I'm onto something really good here, and if I don't get it all out I'm going to lose it. If you don't mind, hon, I could really use the next hour or so to myself."

Not wanting to disturb him, you tiptoe out, shutting the doors quietly behind you.

You can hear Michael in the next room, typing away.

>scenes
Scene 'Entire Game' playing (for 46 mins now)
Scene 'Day 1' ended
Scene 'Michael Reads' ended
Scene 'Michael Follows' ended
Scene 'Michael Sleeps' ended
Scene 'Day 2' ended
Scene 'Michael Showers' ended
Scene 'Michael Writes' playing (for 2 mins now)
Scene 'Day 3' playing (for 7 mins now)
(Scene monitoring now switched on. Type "scenes off" to switch it off again.)

>gonear old man
Vacant Lot
Where once a building stood, there is now only cracked pavement and rampant weeds. A high chain-link fence surrounds this vacant lot; the only breaks lie to the west and southeast.

An old man dressed in dirty rags sits on his mattress, muttering to himself as he stares intently out to sea.

A filthy old mattress lies among the weeds over in one corner of the lot.

>purloin flask
[Purloined.]

>give flask to old man
His eyes burning with greed, the old man snatches the flask from your hand, unscrews the cap and tips it up into his waiting mouth. Trickles of pungent brown liquid ooze from the corners of his mouth as he swallows convulsively, his hands trembling, his eyes squeezed shut and streaming tears. Finally, he falls back onto his mattress with a beatific smile on his mud-smeared face, the flask dropping from his fingers.

[Your score has just gone up by two points.]

>ask man about william. ask man about coffin. show skull to man.
The old man screws his face up in confusion. "Don't know about that," he mutters..

>ask man about william
The old man falls silent all of a sudden, and for a while he simply stares down at his hands, limp and open in his lap. Then, drawing a deep breath, he begins to speak, and for the first time his voice is steady, without the reedy whine of alcoholic craving.

"Ayuh, little Edward had a brother, so he did. And I know him. I know of William, so I do. I delivered the child. Anna Verlac was his mother. It... it was... "

He leans over and grips your arm with a hand that is suddenly steady and strong. "It was her father's poison seed, y'see. That evil bastard poisoned her womb and put a monster inside her. What she gave birth to... it was... it wasn't... oh, God, when I held that... that abortion in the shape of an infant, that thing with hooves for feet and its crown of writhing... when it looked up at me... It looked up at me with its father's red-rimmed eyes." The old man shudders convulsively, and it is a while before he can speak again.

"Anna and I decided between ourselves, we did. The... her child... it lived for a few years, but it was sickly, and in pain, and it could never be normal nor healthy. She brought it to me... I was her doctor, you see, I'd seen her through her child's birth, and she trusted me... and I put the thing down, softly and without pain, and they laid it to rest in the family crypt.

"And Anna thanked me for it, so she did."

The old man falls silent again, and his wavering, bloodshot eyes wander once more out to sea. And he is lost, once again, to the horror and pain of the memories that can only be silenced by drink..

>ask man about coffin
The old man stares at you suspiciously. "William was buried in the family crypt, at his mother's request, so he was; what're you getting at?".

>show skull to man
You can't see any such thing.

>purloin skull
[Purloined.]

>show skull to man
The old man grows sickly pale. He raises one hand, as if to ward off the sight of the skull, deny the truth one more time; then his hand drops, and he sinks down onto the mattress, groaning.

"Oh, it's true," he cries, "it's true, God help my lying soul. It was her father who wished to kill the thing, not Anna -- kill it to make way for another, he said, a "more fitting vessel". He wanted to try again -- Gods, the depth of his evil -- after the way the first one came out, he wanted to try again!

"Anna came to me and asked for my help, and what could I do? What could I do? It was her child, for God's sake, no matter what else it was, and she couldn't bear to lose it. But we had to weigh the coffin down with something..."

He sits up, suddenly, fastening on you with a sick, pleading look.

"I've told you too much, now," he whispers desperately. "They'll know; the maggots'll find out for sure. They'll find me; even in my hole, they'll find me." He lets out an eye-wateringly pungent breath, "P'raps it's best they do. I've spent so long drowning my sins, p'raps time's come to pay for them at last. This won't do me much good no more," he says, holding up his little copper key. "And yet..." He closes his fist around it again. "And yet, maybe there's a way... they say there's ways to protect yourself, wards versus the Evil Eye and such. Perhaps, if I could get me one o'those...

>give amulet to man
You can't see any such thing.

>purloin amulet
[Purloined.]

>give amulet to man
"Thank you kindly, Miss, you're a generous one, so you are," grins the old man as he closes his grimy fingers around the charm. "And here y'are," he says, tossing you the copper key. "I'll pray it does you good."

The old man staggers to his feet. "I'll be gettin" on, then," he says. "If I can make away before nightfall, p'raps I'll be out of their reach before the maggots come out." He wraps the leather thong around his hand and closes the charm in his fist.

He turns to you one last time. "Don't let them find you," he says earnestly. "Get out while you can. If you stay, they'll track you down eventually. It's the blood. He can smell it, so he can. And he always returns to his blood."

He shambles off, up the riverwalk toward Town Square, his shadow dragging long behind him. Looking to the sky, you realize that the sun is nearly set; you've been talking to the old man for much longer than you thought, and it will be dark soon.

[Scene 'Close of Day' begins]
[Scene 'Michael Writes' ends]
[Your score has just gone up by five points.]

>gonear crib
There seems to be no such object anywhere in the model world.

>gonear hole
*** Run-time problem P61: Attempt to move the player off-stage.

>gonear jewelry
Darkness
It is pitch dark, and you can't see a thing.

>turn on light
You can't see any such thing.

>purloin light
[Purloined.]

>turn on light
You switch the flashlight on.

Kid's Room
This must be the children's bedroom. The bed is smaller than the one in the master bedroom, its bright coverlet providing one of the few feeble splashes of color in what must have been, for most of its history, a joylessly Puritan household. A small vanity table occupies the opposite wall, and in the corner under the window stands an ancient crib. The only exit is to the north.

A child's jewelry box sits on the corner of the vanity.

>n
Upstairs Hall
The shuttered window at the end of the hall throws a gloomy rectangle of light onto the bare wooden floor. Doorways lead north and south.

There is a cord dangling in mid-air here, right about level with your face.

>n
Library
Whatever else their faults may have been, the Verlacs were evidently not ones to shun the printed word. Books line the walls from floor to ceiling in this dark-paneled, green-carpeted room, interrupted only by doorways to the east and south. A rich, brown leather armchair sits in stately repose near the window, with a polished brass pipe stand nearby completing the picture of some blue-blooded country squire's literary refuge. Once again, you are struck by how easily this place could have been the perfect home.

A beautiful pair of mahogany sliding doors stand closed to the east.

Resting on the pipe stand is a sizable volume decorated with a gilded pentagram on its cover.

>e
(first opening the mahogany doors)
You can't, since the mahogany doors lead nowhere.

>open doors
They're already open.

* * *

>scenes
Scene 'Entire Game' playing (for 2 mins now)
Scene 'Day 1' playing (for 2 mins now)
Scene 'Michael Reads' playing (for 2 mins now)
(Scene monitoring now switched on. Type "scenes off" to switch it off again.)

* * *

>day
I didn't understand that sentence.

* * *

The oldest and strongest emotion of mankind
is fear, and the oldest and strongest kind of
fear is fear of the unknown.

-- H.P. Lovecraft
                                                                                                                                                                                                                                                  I N F O R M H E A D

Please press SPACE to continue.

>day1
That's not a verb I recognise.

* * *

>l
Master Bedroom (on the bed)
The master bedroom is a picture-postcard of rustic New England charm. Faded sketches of rural landscapes adorn the walls; a beautifully carved dressing mirror stands in one corner; an old-fashioned accordion radiator gurgles quietly beneath the window. The most striking feature, an enormous, antique, four-poster bed, must be the largest piece of furniture in the house.

On the four-poster bed you can see Michael's pants.

Michael is here.

You can also see a keyring, a house key and a cellar key here.

>x pants
They're the same plain khakis he usually wears. You notice something in the back pocket.

>take pants
Taken.

>search pants
In Michael's pants is Michael's wallet.

>search wallet
In Michael's wallet is Michael's faculty card.

>take card
The shower suddenly stops. Quickly you palm the card, replace the wallet and arrange the pants the way you found them. A moment later Michael emerges from the bathroom, toweling his hair. "My, don't you look tempting this morning," he says, giving you a kiss. He tosses the towel back into the bathroom and gets dressed. "I think I'm going to stay home and get some writing done. I don't actually start work until tomorrow, so..." He kisses you on the cheek as he walks out into the hall. "If you go out today, see if you can find a newspaper. I want to learn as much as I can about this town."

He looks at you for a moment, and his voice becomes serious. "I love you, hon. You know that, don't you? I really want us to try and be happy here."

Then he turns and pads down the hall.

You take a deep breath as he goes. You've never lied to Michael or hidden anything from him before, ever; now, hardly two days into your new life, you're already sneaking through his wallet.

Oh yeah. You're off to a great start.

>i
You are carrying:
  Michael's faculty card
  your clothes (being worn)
  your trenchcoat (being worn)
  your wedding ring (being worn)

>l
Master Bedroom (on the bed)
The master bedroom is a picture-postcard of rustic New England charm. Faded sketches of rural landscapes adorn the walls; a beautifully carved dressing mirror stands in one corner; an old-fashioned accordion radiator gurgles quietly beneath the window. The most striking feature, an enormous, antique, four-poster bed, must be the largest piece of furniture in the house.

Michael is here.

You can also see a keyring, a house key and a cellar key here.

>take all
keyring: Taken.
house key: Taken.
cellar key: Taken.

* * *

The oldest and strongest emotion of mankind
is fear, and the oldest and strongest kind of
fear is fear of the unknown.

-- H.P. Lovecraft
                                                                                                                                                                                                                                                  I N F O R M H E A D

Please press SPACE to continue.

>day2
That's not a verb I recognise.

>go2
You wake up. Steam billows gently by, and you can hear the sound of running water coming from the bathroom.

>stand
You get off the bed.

Master Bedroom
The master bedroom is a picture-postcard of rustic New England charm. Faded sketches of rural landscapes adorn the walls; a beautifully carved dressing mirror stands in one corner; an old-fashioned accordion radiator gurgles quietly beneath the window. The most striking feature, an enormous, antique, four-poster bed, must be the largest piece of furniture in the house.

On the four-poster bed you can see Michael's pants.

Someone has left a flask underneath one of the tables.

An old, discarded tin of fish oil sits at the end of the pier.

You can also see your trenchcoat, your clothes, your keyring (empty), your umbrella, a house key and a cellar key here.

>take all
Michael's pants: You take Michael's pants. They're the same plain khakis he usually wears. You notice something in the back pocket..
trenchcoat: You put on the trenchcoat.
clothes: You put on the clothes.
keyring: You take the keyring. .
umbrella: You take the umbrella. It's olive green, with a hook-shaped handle. A handy little thing, when it rains. It's currently closed..
flask: You take the flask. The label is faded and mostly peeled away, but what little you can make out seems to indicate that this is not a particularly distinguished brand of spirits. The words "bootleg" and "rotgut" come to mind, probably because they are the only words legible on what's left of the label..
old tin: You take the old tin. .
house key: You take the house key. It's an ordinary-looking key. The word "house" is written on a tiny piece of tape affixed to the key's tab..
cellar key: You take the cellar key. It's an ordinary-looking key. The word "cellar" is written on a tiny piece of tape affixed to the key's tab..
Michael's wallet: You take Michael's wallet. It's just his wallet, an ordinary leather wallet..

>drop pants
Dropped.

>drop wallet
Dropped.

>s. e.
Upstairs Landing
A narrow hallway runs east, from the top of the stairs down the length of the house. To the north, directly opposite the stairs, is the master bedroom.

Upstairs Hall
The shuttered window at the end of the hall throws a gloomy rectangle of light onto the bare wooden floor. Doorways lead north and south.

There is a cord dangling in mid-air here, right about level with your face

There is a cord dangling in mid-air here, right about level with your face.

* * *

>l
Outside the Real Estate Office
A grim little cul-de-sac, tucked away in a corner of the claustrophobic tangle of narrow, twisting avenues that largely constitute the older portion of Anchorhead. Like most of the streets in this city, it is ancient, shadowy, and leads essentially nowhere. The lane ends here at the real estate agent's office, which lies to the east, and winds its way back toward the center of town to the west. A narrow, garbage-choked alley opens to the southeast.

* * *

The oldest and strongest emotion of mankind
is fear, and the oldest and strongest kind of
fear is fear of the unknown.

-- H.P. Lovecraft
                                                                                                                                                                                                                                                  I N F O R M H E A D

Please press SPACE to continue.

>drop all
umbrella: Dropped.
keyring: Dropped.

>showme umbrella
umbrella - thing
location: in Outside the Real Estate Office
unlit, inedible, portable, handled; singular-named, improper-named; open
description: "Olive green, with a hook-shaped handle. It's a handy little thing, when it rains. It's currently closed."
initial appearance: none
printing: "blank"
printed name: "umbrella"
printed plural name: none
indefinite article: "your"
list grouping key: none

>take umbrella
You take the umbrella
Taken.

* * *

The oldest and strongest emotion of mankind
is fear, and the oldest and strongest kind of
fear is fear of the unknown.

-- H.P. Lovecraft
                                                                                                                                                                                                                                                  I N F O R M H E A D

Please press SPACE to continue.

>drop clothes
(first taking the clothes off)
You've never been big on that "natural" look. If you decide you need to take a bath or go to bed, you can disrobe then; otherwise, keep "em on.

>drop trenchcoat
(first taking the trenchcoat off)
Dropped.

* * *

>l
Master Bedroom (on the bed)
The master bedroom is a picture-postcard of rustic New England charm. Faded sketches of rural landscapes adorn the walls; a beautifully carved dressing mirror stands in one corner; an old-fashioned accordion radiator gurgles quietly beneath the window. The most striking feature, an enormous, antique, four-poster bed, must be the largest piece of furniture in the house.

On the four-poster bed you can see Michael's pants.

You can also see your trenchcoat, your clothes, your keyring (empty), your umbrella, a house key and a cellar key here.

>stand
You get off the bed.

Master Bedroom
The master bedroom is a picture-postcard of rustic New England charm. Faded sketches of rural landscapes adorn the walls; a beautifully carved dressing mirror stands in one corner; an old-fashioned accordion radiator gurgles quietly beneath the window. The most striking feature, an enormous, antique, four-poster bed, must be the largest piece of furniture in the house.

On the four-poster bed you can see Michael's pants.

You can also see your trenchcoat, your clothes, your keyring (empty), your umbrella, a house key and a cellar key here.

>take clothes
You put on the clothes.

>drop clothes
(first taking the clothes off)
Dropped.

>take all
clothes: You put on the clothes.
Michael's pants: You take Michael's pants. They're the same plain khakis he usually wears..
trenchcoat: You put on the trenchcoat.
keyring: You take the keyring. .
umbrella: You take the umbrella. It's olive green, with a hook-shaped handle. A handy little thing, when it rains. It's currently closed..
house key: You take the house key. .
cellar key: You take the cellar key. .
Michael's wallet: You take Michael's wallet. .
Michael's faculty card: The shower suddenly stops. Quickly you palm the card, replace the wallet and arrange the pants the way you found them. A moment later Michael emerges from the bathroom, toweling his hair. "My, don't you look tempting this morning," he says, giving you a kiss. He tosses the towel back into the bathroom and gets dressed. "I think I'm going to stay home and get some writing done. I don't actually start work until tomorrow, so..." He kisses you on the cheek as he walks out into the hall. "If you go out today, see if you can find a newspaper. I want to learn as much as I can about this town."

He looks at you for a moment, and his voice becomes serious. "I love you, hon. You know that, don't you? I really want us to try and be happy here."

Then he turns and pads down the hall.

You take a deep breath as he goes. You've never lied to Michael or hidden anything from him before, ever; now, hardly two days into your new life, you're already sneaking through his wallet.

Oh yeah. You're off to a great start.

>i
You are carrying:
  Michael's faculty card
  a cellar key
  a house key
  your umbrella
  your keyring
  your trenchcoat (being worn)
  your clothes (being worn)
  your wedding ring (being worn)

* * *

The oldest and strongest emotion of mankind
is fear, and the oldest and strongest kind of
fear is fear of the unknown.

-- H.P. Lovecraft
                                                                                                                                                                                                                                                  I N F O R M H E A D

Please press SPACE to continue.

>drop umbrella
Dropped.

>take it
You take the umbrella
*** Run-time problem P10: Since the umbrella is not allowed the property "last turn examined", it is against the rules to try to use it.

.

* * *

The oldest and strongest emotion of mankind
is fear, and the oldest and strongest kind of
fear is fear of the unknown.

-- H.P. Lovecraft
                                                                                                                                                                                                                                                  I N F O R M H E A D

Please press SPACE to continue.

>drop umbrella. take it.
Dropped.

You hear a soft rattle behind you, like an empty tin can rolling across the uneven ground. When you turn, there is no one there.

You take the umbrella. Olive green, with a hook-shaped handle. It's a handy little thing, when it rains. It's currently closed..

>drop umbrella. take it.
Dropped.

You take the umbrella.

>drop umbrella. take it.
Dropped.

You take the umbrella. Olive green, with a hook-shaped handle. It's a handy little thing, when it rains. It's currently closed..

>showme umbrella
umbrella - thing
location: carried by yourself in Outside the Real Estate Office
unlit, inedible, portable, handled; singular-named, improper-named; open
description: "Olive green, with a hook-shaped handle. It's a handy little thing, when it rains. It's currently closed."
initial appearance: none
last turn examined: -2
printing: "blank"
printed name: "umbrella"
printed plural name: none
indefinite article: "your"
list grouping key: none

* * *

>drop umbrella. take it.
Dropped.

You take the umbrella.

>i
You are carrying:
  your umbrella
  your clothes (being worn)
  your trenchcoat (being worn)
  your wedding ring (being worn)
  your keyring

>x keyring
The keyring is empty.

>drop keyring. take it.
Dropped.

You take the keyring.

The rain slackens off momentarily to a weak drizzle, then returns afresh in a brief, freezing downpour.

>x sky
The sky is an unbroken blanket of seething gray clouds in every direction.

You hear a soft rattle behind you, like an empty tin can rolling across the uneven ground. When you turn, there is no one there.

>showme sky
sky - backdrop
location: in Outside the Real Estate Office
unlit, inedible, fixed in place, scenery; singular-named, improper-named
description: "The sky is an unbroken blanket of seething gray clouds in every direction."
initial appearance: none
last turn examined: 9
printing: "blank"
printed name: "sky"
printed plural name: "backdrops"
indefinite article: none
list grouping key: none

>take sky
That's hardly portable.

* * *

>drop umbrella. take it.
Dropped.

You take the umbrella.

>showme umbrella
umbrella - thing
location: carried by yourself in Outside the Real Estate Office
unlit, inedible, portable, handled; singular-named, improper-named; open
description: "Olive green, with a hook-shaped handle. It's a handy little thing, when it rains. It's currently closed."
initial appearance: none
printing: "blank"
printed name: "umbrella"
printed plural name: none
indefinite article: "your"
list grouping key: none

>x umbrella
Olive green, with a hook-shaped handle. It's a handy little thing, when it rains. It's currently closed.

>showme umbrella
umbrella - thing
location: carried by yourself in Outside the Real Estate Office
unlit, inedible, portable, handled; singular-named, improper-named; open
description: "Olive green, with a hook-shaped handle. It's a handy little thing, when it rains. It's currently closed."
initial appearance: none
printing: "blank"
printed name: "umbrella"
printed plural name: none
indefinite article: "your"
list grouping key: none

* * *

The oldest and strongest emotion of mankind
is fear, and the oldest and strongest kind of
fear is fear of the unknown.

-- H.P. Lovecraft
                                                                                                                                                                                                                                                  I N F O R M H E A D

Please press SPACE to continue.

>e
Upstairs Hall
The shuttered window at the end of the hall throws a gloomy rectangle of light onto the bare wooden floor. Doorways lead north and south.

There is a cord dangling in mid-air here, right about level with your face.

>e
(first opening the church door)

Courtyard
You can see a church door here.

>open door
You open Brackhurst Door.

>e
You can't go that way.

>enter door
You can't go that way.

* * *

>e
Upstairs Hall
The shuttered window at the end of the hall throws a gloomy rectangle of light onto the bare wooden floor. Doorways lead north and south.

There is a cord dangling in mid-air here, right about level with your face.

>n
Library
Whatever else their faults may have been, the Verlacs were evidently not ones to shun the printed word. Books line the walls from floor to ceiling in this dark-paneled, green-carpeted room, interrupted only by doorways to the east and south. A rich, brown leather armchair sits in stately repose near the window, with a polished brass pipe stand nearby completing the picture of some blue-blooded country squire's literary refuge. Once again, you are struck by how easily this place could have been the perfect home.

A beautiful pair of mahogany sliding doors stand closed to the east.

Resting on the pipe stand is a sizable volume decorated with a gilded pentagram on its cover.

>l
Library
Whatever else their faults may have been, the Verlacs were evidently not ones to shun the printed word. Books line the walls from floor to ceiling in this dark-paneled, green-carpeted room, interrupted only by doorways to the east and south. A rich, brown leather armchair sits in stately repose near the window, with a polished brass pipe stand nearby completing the picture of some blue-blooded country squire's literary refuge. Once again, you are struck by how easily this place could have been the perfect home.

A beautiful pair of mahogany sliding doors stand closed to the east.

Resting on the pipe stand is a sizable volume decorated with a gilded pentagram on its cover.

>l
Library
Whatever else their faults may have been, the Verlacs were evidently not ones to shun the printed word. Books line the walls from floor to ceiling in this dark-paneled, green-carpeted room, interrupted only by doorways to the east and south. A rich, brown leather armchair sits in stately repose near the window, with a polished brass pipe stand nearby completing the picture of some blue-blooded country squire's literary refuge. Once again, you are struck by how easily this place could have been the perfect home.

A beautiful pair of mahogany sliding doors stand closed to the east.

Resting on the pipe stand is a sizable volume decorated with a gilded pentagram on its cover.

>s
Upstairs Hall
The shuttered window at the end of the hall throws a gloomy rectangle of light onto the bare wooden floor. Doorways lead north and south.

There is a cord dangling in mid-air here, right about level with your face.

>n
Library
Whatever else their faults may have been, the Verlacs were evidently not ones to shun the printed word. Books line the walls from floor to ceiling in this dark-paneled, green-carpeted room, interrupted only by doorways to the east and south. A rich, brown leather armchair sits in stately repose near the window, with a polished brass pipe stand nearby completing the picture of some blue-blooded country squire's literary refuge. Once again, you are struck by how easily this place could have been the perfect home.

A beautiful pair of mahogany sliding doors stand closed to the east.

Resting on the pipe stand is a sizable volume decorated with a gilded pentagram on its cover.

>take wards
Taken.

>l
Library
Whatever else their faults may have been, the Verlacs were evidently not ones to shun the printed word. Books line the walls from floor to ceiling in this dark-paneled, green-carpeted room, interrupted only by doorways to the east and south. A rich, brown leather armchair sits in stately repose near the window, with a polished brass pipe stand nearby completing the picture of some blue-blooded country squire's literary refuge. Once again, you are struck by how easily this place could have been the perfect home.

A beautiful pair of mahogany sliding doors stand closed to the east.

>drop it
Dropped.

>l
Library
Whatever else their faults may have been, the Verlacs were evidently not ones to shun the printed word. Books line the walls from floor to ceiling in this dark-paneled, green-carpeted room, interrupted only by doorways to the east and south. A rich, brown leather armchair sits in stately repose near the window, with a polished brass pipe stand nearby completing the picture of some blue-blooded country squire's literary refuge. Once again, you are struck by how easily this place could have been the perfect home.

A beautiful pair of mahogany sliding doors stand closed to the east.

You can also see The Compleat Manual of Wardes and Seales here.

* * *

>solve safe
I didn't understand that sentence.

>solve the safe
The tumblers tick quietly as you turn the dial to 41.

The tumblers tick quietly as you turn the dial to 35.

The tumblers tick quietly as you turn the dial to 41.

With a hollow thunk, the safe suddenly swings open.

[Your score has just gone up by two points.]

>l
Library
Whatever else their faults may have been, the Verlacs were evidently not ones to shun the printed word. Books line the walls from floor to ceiling in this dark-paneled, green-carpeted room, interrupted only by doorways to the east and south. A rich, brown leather armchair sits in stately repose near the window, with a polished brass pipe stand nearby completing the picture of some blue-blooded country squire's literary refuge. Once again, you are struck by how easily this place could have been the perfect home.

A beautiful pair of mahogany sliding doors stand closed to the east.

Resting on the pipe stand is a sizable volume decorated with a gilded pentagram on its cover.

>showme safe
safe - open container
    dial (part of safe)
    puzzle box
    strange metal flute
location: out of play
unlit, inedible, portable, handled; opaque, open, unopenable, unlocked; singular-named, improper-named
description: "It's a stark cube of black, oily steel, fifteen inches to a side. Its only feature is large calibrated dial set into the frontThe safe stands open."
initial appearance: "A section of the shelves in the western wall has slid to one side, revealing a hidden safe."
printing: "blank"
carrying capacity: 100
printed name: "safe"
printed plural name: "containers"
indefinite article: none
list grouping key: none
stage: 2
m3: 41
m2: 35
m1: 41

>showme stand
pipe stand - supporter
    The Compleat Manual of Wardes and Seales
location: in Library
unlit, inedible, fixed in place, scenery; transparent; singular-named, improper-named
description: "It's a beautiful piece of work, although at the moment, sadly, it contains no pipe."
initial appearance: none
printing: "blank"
carrying capacity: 100
printed name: "pipe stand"
printed plural name: "supporters"
indefinite article: none
list grouping key: none

>l
Library
Whatever else their faults may have been, the Verlacs were evidently not ones to shun the printed word. Books line the walls from floor to ceiling in this dark-paneled, green-carpeted room, interrupted only by doorways to the east and south. A rich, brown leather armchair sits in stately repose near the window, with a polished brass pipe stand nearby completing the picture of some blue-blooded country squire's literary refuge. Once again, you are struck by how easily this place could have been the perfect home.

A beautiful pair of mahogany sliding doors stand closed to the east.

Resting on the pipe stand is a sizable volume decorated with a gilded pentagram on its cover.

>x books
Literally hundreds of books stuff the shelves, many of them thick, cracked, leather-bound tomes with ribbon place-holders and titles lettered in raised gold leaf. It would take you years to peruse them all. However, one interesting title does catch your eye. An authentic first printing of Edgar Allen Poe's Tales of Mystery and Imagination, shelved incongruously between volumes "G" and "H" of the Encyclopedia Americana.

>pull poe
The book sticks stubbornly at first, and, thinking that it must be tightly wedged in between the encyclopediae, you give it a fierce jerk. Suddenly, the book slides halfway out, then pops back in with a loud "snick".

Amazingly, a section of the bookshelf slides back, revealing a hidden safe.

[Your score has just gone up by one point.]

>l
Library
Whatever else their faults may have been, the Verlacs were evidently not ones to shun the printed word. Books line the walls from floor to ceiling in this dark-paneled, green-carpeted room, interrupted only by doorways to the east and south. A rich, brown leather armchair sits in stately repose near the window, with a polished brass pipe stand nearby completing the picture of some blue-blooded country squire's literary refuge. Once again, you are struck by how easily this place could have been the perfect home.

A section of the shelves in the western wall has slid to one side, revealing a hidden safe.

A beautiful pair of mahogany sliding doors stand closed to the east.

Resting on the pipe stand is a sizable volume decorated with a gilded pentagram on its cover.

You can also see a safe (in which are a puzzle box and a strange metal flute) here.

>x safe
It's a stark cube of black, oily steel, fifteen inches to a side. Its only feature is large calibrated dial set into the frontThe safe stands open.

In the safe are a puzzle box and a strange metal flute.

>l
Library
Whatever else their faults may have been, the Verlacs were evidently not ones to shun the printed word. Books line the walls from floor to ceiling in this dark-paneled, green-carpeted room, interrupted only by doorways to the east and south. A rich, brown leather armchair sits in stately repose near the window, with a polished brass pipe stand nearby completing the picture of some blue-blooded country squire's literary refuge. Once again, you are struck by how easily this place could have been the perfect home.

A section of the shelves in the western wall has slid to one side, revealing a hidden safe.

A beautiful pair of mahogany sliding doors stand closed to the east.

Resting on the pipe stand is a sizable volume decorated with a gilded pentagram on its cover.

You can also see a safe (in which are a puzzle box and a strange metal flute) here.

>s
Upstairs Hall
The shuttered window at the end of the hall throws a gloomy rectangle of light onto the bare wooden floor. Doorways lead north and south.

There is a cord dangling in mid-air here, right about level with your face.

>n
Library
Whatever else their faults may have been, the Verlacs were evidently not ones to shun the printed word. Books line the walls from floor to ceiling in this dark-paneled, green-carpeted room, interrupted only by doorways to the east and south. A rich, brown leather armchair sits in stately repose near the window, with a polished brass pipe stand nearby completing the picture of some blue-blooded country squire's literary refuge. Once again, you are struck by how easily this place could have been the perfect home.

A section of the shelves in the western wall has slid to one side, revealing a hidden safe.

A beautiful pair of mahogany sliding doors stand closed to the east.

Resting on the pipe stand is a sizable volume decorated with a gilded pentagram on its cover.

You can also see a safe (in which are a puzzle box and a strange metal flute) here.

>l
Library
Whatever else their faults may have been, the Verlacs were evidently not ones to shun the printed word. Books line the walls from floor to ceiling in this dark-paneled, green-carpeted room, interrupted only by doorways to the east and south. A rich, brown leather armchair sits in stately repose near the window, with a polished brass pipe stand nearby completing the picture of some blue-blooded country squire's literary refuge. Once again, you are struck by how easily this place could have been the perfect home.

A section of the shelves in the western wall has slid to one side, revealing a hidden safe.

A beautiful pair of mahogany sliding doors stand closed to the east.

Resting on the pipe stand is a sizable volume decorated with a gilded pentagram on its cover.

You can also see a safe (in which are a puzzle box and a strange metal flute) here.

>take safe
Taken.

>n
You can't go that way.

>s
Upstairs Hall
The shuttered window at the end of the hall throws a gloomy rectangle of light onto the bare wooden floor. Doorways lead north and south.

There is a cord dangling in mid-air here, right about level with your face.

* * *

>drop safe
Dropped.

* * *

>take book
Taken.

>read it
It's an old medieval tome dated in the early 1300s, written by one Galarian Academius desChamps.

>s
Upstairs Hall
The shuttered window at the end of the hall throws a gloomy rectangle of light onto the bare wooden floor. Doorways lead north and south.

>move bed. x hole. take pages.
You can't see any such thing.

>s
Children's Bedroom
This must be the children's bedroom. The bed is smaller than the one in the master bedroom, its bright coverlet providing one of the few feeble splashes of color in what must have been, for most of its history, a joylessly Puritan household. A small vanity table occupies the opposite wall, and in the corner under the window stands an ancient crib. The only exit is to the north.

A child's jewelry box sits on the corner of the vanity.

>move bed. x hole. take pages.
Bracing yourself, you push the bed away from the wall, revealing a ragged hole in the wood paneling.

It's about six inches wide, and looks like it was made by by someone breaking in the wall with a hammer and pulling chunks of paneling out with their bare hands

In the hole is a bundle of soggy pages.

Taken.

[Your score has just gone up by two points.]

>read it
It appears to have been someone's diary. There must have been a leak at some time behind the wall where it was hidden, because most of the pages are water-logged and completely illegible. However, portions of a few entries remain untouched.

>x it
It appears to have been someone's diary. There must have been a leak at some time behind the wall where it was hidden, because most of the pages are water-logged and completely illegible. However, portions of a few entries remain untouched.

>search it
You find nothing of interest.

>consult it about foo
Carefully, you turn the tattered pages. The handwriting is that of a young girl. You idly wonder if this might have been the diary of one of Edward Verlac's daughters -- but then you notice part of a date, just visible in the corner of the page: 1953. This must have been written, then, several years before Edward was born.

The entries that are legible read as follows:

...Father came again to my bed last night... mother doesn't... tells me I can't... to be a good daughter. Sometimes it hurts, but Father always tells me I shouldn't cry. Father says a daughter must do her Duty if she wants to get into Heaven. And I do want to get into Heaven...

(this entry dated 1957) ...my poor little William. Father calls him an aberration, child of the Devil, but I don't believe... locked in the attic. I go to see him whenever Father is away. I sing to him, sometimes, through the keyhole, and slip him sweets through the crack under the door... my baby is beautiful... can't let him hurt my dear baby William... to the doctor, and he has a plan... I can never... this locket, William, and I will always keep yours... to always remember my face...

Nothing else is readable except for one fragmented entry near the very end of the book, the date in the corner reading February 27, 1961:

...dead, but not dead yet... will not allow him to do to Edward what he wanted to do to William... have learned... given him the charm against the... never take it off, dear Edward... (a page has been torn away) ...fear to sleep... mist at the window --

And that's all.

* * *

>read it
It's an old medieval tome dated in the early 1300s, written by one Galarian Academius desChamps.

>search it
Essentially, it's a textbook on the theory and practice of magickal wards and seals, mystic symbols inscribed on doors and containers in order to keep people and spirits out -- or in. It's all very deliberately vague and arcane (in addition to being written in medieval French and translated into Middle English, making it nearly impossible to understand), the kind of thing that likely got many a scholar burned at the stake in those days.

You are surprised to find that a page in this old and probably quite valuable book has been folded down, as though to mark the place. The section marked discusses various methods of opening doors that have been sealed with the image of a pagan god. Speaking aloud the deity's true name will usually do the trick, apparently.

>s
Upstairs Hall
The shuttered window at the end of the hall throws a gloomy rectangle of light onto the bare wooden floor. Doorways lead north and south.

* * *

>read it
It's an old medieval tome dated in the early 1300s, written by one Galarian Academius desChamps.

>x it
It's an old medieval tome dated in the early 1300s, written by one Galarian Academius desChamps.

* * *

>take book. read it.
Taken.

It's an old medieval tome dated in the early 1300s, written by one Galarian Academius desChamps.

* * *

>x books
Literally hundreds of books stuff the shelves, many of them thick, cracked, leather-bound tomes with ribbon place-holders and titles lettered in raised gold leaf. It would take you years to peruse them all. However, one interesting title does catch your eye. An authentic first printing of Edgar Allen Poe's Tales of Mystery and Imagination, shelved incongruously between volumes "G" and "H" of the Encyclopedia Americana.

* * *

>pull poe
The book sticks stubbornly at first, and, thinking that it must be tightly wedged in between the encyclopediae, you give it a fierce jerk. Suddenly, the book slides halfway out, then pops back in with a loud "snick".

Amazingly, a section of the bookshelf slides back, revealing a hidden safe.

[Your score has just gone up by one point.]

>l
Library
Whatever else their faults may have been, the Verlacs were evidently not ones to shun the printed word. Books line the walls from floor to ceiling in this dark-paneled, green-carpeted room, interrupted only by doorways to the east and south. A rich, brown leather armchair sits in stately repose near the window, with a polished brass pipe stand nearby completing the picture of some blue-blooded country squire's literary refuge. Once again, you are struck by how easily this place could have been the perfect home.

A section of the shelves in the western wall has slid to one side, revealing a hidden safe.

A section of the shelves in the western wall has slid to one side, revealing a hidden safe.

A beautiful pair of mahogany sliding doors stand closed to the east.

Resting on the pipe stand is a sizable volume decorated with a gilded pentagram on its cover.

>l
Library
Whatever else their faults may have been, the Verlacs were evidently not ones to shun the printed word. Books line the walls from floor to ceiling in this dark-paneled, green-carpeted room, interrupted only by doorways to the east and south. A rich, brown leather armchair sits in stately repose near the window, with a polished brass pipe stand nearby completing the picture of some blue-blooded country squire's literary refuge. Once again, you are struck by how easily this place could have been the perfect home.

A section of the shelves in the western wall has slid to one side, revealing a hidden safe.

A section of the shelves in the western wall has slid to one side, revealing a hidden safe.

A beautiful pair of mahogany sliding doors stand closed to the east.

Resting on the pipe stand is a sizable volume decorated with a gilded pentagram on its cover.

>take safe
That's fixed in place.

>l
Library
Whatever else their faults may have been, the Verlacs were evidently not ones to shun the printed word. Books line the walls from floor to ceiling in this dark-paneled, green-carpeted room, interrupted only by doorways to the east and south. A rich, brown leather armchair sits in stately repose near the window, with a polished brass pipe stand nearby completing the picture of some blue-blooded country squire's literary refuge. Once again, you are struck by how easily this place could have been the perfect home.

A section of the shelves in the western wall has slid to one side, revealing a hidden safe.

A section of the shelves in the western wall has slid to one side, revealing a hidden safe.

A beautiful pair of mahogany sliding doors stand closed to the east.

Resting on the pipe stand is a sizable volume decorated with a gilded pentagram on its cover.

>s
Upstairs Hall
The shuttered window at the end of the hall throws a gloomy rectangle of light onto the bare wooden floor. Doorways lead north and south.

There is a cord dangling in mid-air here, right about level with your face.

>n
Library
Whatever else their faults may have been, the Verlacs were evidently not ones to shun the printed word. Books line the walls from floor to ceiling in this dark-paneled, green-carpeted room, interrupted only by doorways to the east and south. A rich, brown leather armchair sits in stately repose near the window, with a polished brass pipe stand nearby completing the picture of some blue-blooded country squire's literary refuge. Once again, you are struck by how easily this place could have been the perfect home.

A section of the shelves in the western wall has slid to one side, revealing a hidden safe.

A section of the shelves in the western wall has slid to one side, revealing a hidden safe.

A beautiful pair of mahogany sliding doors stand closed to the east.

Resting on the pipe stand is a sizable volume decorated with a gilded pentagram on its cover.

>open safe
There's no handle on the door; it opens when you get the combination right.

>solve the safe
The tumblers tick quietly as you turn the dial to 51.

The tumblers tick quietly as you turn the dial to 21.

The tumblers tick quietly as you turn the dial to 2.

With a hollow thunk, the safe suddenly swings open.

[Your score has just gone up by two points.]

>l
Library
Whatever else their faults may have been, the Verlacs were evidently not ones to shun the printed word. Books line the walls from floor to ceiling in this dark-paneled, green-carpeted room, interrupted only by doorways to the east and south. A rich, brown leather armchair sits in stately repose near the window, with a polished brass pipe stand nearby completing the picture of some blue-blooded country squire's literary refuge. Once again, you are struck by how easily this place could have been the perfect home.

A section of the shelves in the western wall has slid to one side, revealing a hidden safe.

A beautiful pair of mahogany sliding doors stand closed to the east.

Resting on the pipe stand is a sizable volume decorated with a gilded pentagram on its cover.

You can also see a safe (in which are a puzzle box and a strange metal flute) here.

* * *

>x stand
It's a beautiful piece of work, although at the moment, sadly, it contains no pipe.

On the pipe stand is The Compleat Manual of Wardes and Seales.

>take stand
That's hardly portable.

>take wardes
You can't see any such thing.

>take wards
Taken.

* * *

>l
Library
Whatever else their faults may have been, the Verlacs were evidently not ones to shun the printed word. Books line the walls from floor to ceiling in this dark-paneled, green-carpeted room, interrupted only by doorways to the east and south. A rich, brown leather armchair sits in stately repose near the window, with a polished brass pipe stand nearby completing the picture of some blue-blooded country squire's literary refuge. Once again, you are struck by how easily this place could have been the perfect home.

A beautiful pair of mahogany sliding doors stand closed to the east.

>drop wards
Dropped.

>l
Library
Whatever else their faults may have been, the Verlacs were evidently not ones to shun the printed word. Books line the walls from floor to ceiling in this dark-paneled, green-carpeted room, interrupted only by doorways to the east and south. A rich, brown leather armchair sits in stately repose near the window, with a polished brass pipe stand nearby completing the picture of some blue-blooded country squire's literary refuge. Once again, you are struck by how easily this place could have been the perfect home.

Resting on the pipe stand is a sizable volume decorated with a gilded pentagram on its cover.

A beautiful pair of mahogany sliding doors stand closed to the east.

You can also see The Compleat Manual of Wardes and Seales here.

* * *

>e
Upstairs Hall
The shuttered window at the end of the hall throws a gloomy rectangle of light onto the bare wooden floor. Doorways lead north and south.

There is a cord dangling in mid-air here, right about level with your face.

>ne
The street goes west from here. You can enter the office to the east or the alley to the southeast.

>test hatch
(Testing.)

>[1] w

Narrow Street
As the lane winds along from east to west, it narrows until the steep, jagged rooftops on either side of the street practically touch each other. To the south, a side street leads across Whateley Bridge toward the center of town, and a twisting lane leads up a hill to the northwest. A short flight of steps to the north leads down to the local watering hole.

>[2] w

Junction
To the north, a gap in the crowded press of gloomy buildings opens onto a country lane, heading out over a grassy heath. The main street continues to the east, while to the northwest, over the top of a steep rise, you can just make out the vaulted rooftops of the university.

>[3] n

Mill Road
The road carries you across a desolate heath of gray, windswept grass. To the south, the black, jagged outline of Anchorhead's steep roofs and sharp, leaning gables cuts across the horizon. The road forks here to the west and east, heading across the railroad tracks in one direction, out toward the seashore in the other.

>[4] w
As you cross the railroad tracks, the air becomes warmer, more dingy, and slightly more difficult to breathe.

Entrance to the Paper Mill
The road turns southwest here and runs squarely through the front entrance to the old paper mill. A gate of heavy iron bars blocks the only opening into this charred fortress, although an overgrown path leads around the wall to the south. To the north, a rutted lane threads its way past a row of dilapidated shacks.

>[5] nw
The road goes north and east from here. The mill gate lies southwest, and an overgrown trail leads south.

>[6] s
The path curves southwest, leading you into an overgrown area behind the mill.

Bare Foundations
The foundations of an older structure lie crumbling in a sunken square of ground, hidden away behind the imposing shadow of the mill wall. Weeds push up through cracked and buckling slabs of concrete; twisted rebar and rusting pipes poke up like the legs of dead insects. The ruins are surrounded on all sides by dense thickets, although narrow, overgrown trails lead northeast and southeast through the underbrush.

>[7] e
The thickets are too dense in that direction.

>[8] search thicket
Carefully pushing the prickly branches aside, you find a rusty metal hatch set into the base of the wall.

>[9] l
Bare Foundations
The foundations of an older structure lie crumbling in a sunken square of ground, hidden away behind the imposing shadow of the mill wall. Weeds push up through cracked and buckling slabs of concrete; twisted rebar and rusting pipes poke up like the legs of dead insects. The ruins are surrounded on all sides by dense thickets, although narrow, overgrown trails lead northeast and southeast through the underbrush.

Set into the base of the mill wall, nearly covered by the thickets, is a metal hatch.

>n
(first opening the hatch)
It seems to be locked.

>restart
Are you sure you want to restart?

>yes
Informhead
An Interactive Fiction by Ed Peters
Release 1 / Serial number 230519 / Inform 7 v10.1.2 / D

Outside the Real Estate Office
A grim little cul-de-sac, tucked away in a corner of the claustrophobic tangle of narrow, twisting avenues that largely constitute the older portion of Anchorhead. Like most of the streets in this city, it is ancient, shadowy, and leads essentially nowhere. The lane ends here at the real estate agent's office, which lies to the east, and winds its way back toward the center of town to the west. A narrow, garbage-choked alley opens to the southeast.

* * *

>e
Upstairs Hall
The shuttered window at the end of the hall throws a gloomy rectangle of light onto the bare wooden floor. Doorways lead north and south.

There is a cord dangling in mid-air here, right about level with your face.

>open door
It seems to be locked.

>x door
The door has a glass front with the name of the real estate company -- Benson & Brackhurst -- stenciled across it. The blinds are drawn, the lights are off inside, and no one appears to be home. Odd, since the agent knew you were coming today.

>e
The street goes west from here. You can enter the office to the east or the alley to the southeast.

* * *

>e
Upstairs Hall
The shuttered window at the end of the hall throws a gloomy rectangle of light onto the bare wooden floor. Doorways lead north and south.

There is a cord dangling in mid-air here, right about level with your face.

>pull cord
With a rusty, ratcheting groan and a brief shower of dust, the trap door swings down and folds back, revealing a rickety wooden ladder leading up into darkness.

>u
The ancient rungs creak alarmingly as you ascend.

Attic
It's much cooler up here than in the rest of the house, and you find it hard to suppress a shiver. Grotesque, looming shadows crawl across the low, slanted ceiling, and the dust hangs thick and motionless in the air. To the west the ceiling dips even lower until the space beneath leaves hardly room enough to crawl, while to the north stands a wooden door, draped in shadows and half-hidden by the slanting eaves.

You can see a wood door here.

>x door
It's an ordinary wooden door, unremarkable except for the antique metal keyplate. Beneath the door, a thin line of faint light is barely visible.

>x keyplate
The keyhole is of the classic round-hole-atop-a-triangular-hole variety, the kind people are always peeping through in cartoons.

>look through keyplate
The keyhole is dark, as though blocked by something.

>look under door
Dropping to your hands and knees and placing your eye close to the crack beneath the door, you can make out a dim light coming from somewhere up above, and a great deal of dust on the floorboards.

* * *

>e
Upstairs Hall
The shuttered window at the end of the hall throws a gloomy rectangle of light onto the bare wooden floor. Doorways lead north and south.

There is a cord dangling in mid-air here, right about level with your face.

>s
Children's Bedroom
This must be the children's bedroom. The bed is smaller than the one in the master bedroom, its bright coverlet providing one of the few feeble splashes of color in what must have been, for most of its history, a joylessly Puritan household. A small vanity table occupies the opposite wall, and in the corner under the window stands an ancient crib. The only exit is to the north.

A child's jewelry box sits on the corner of the vanity.

>move bed
Bracing yourself, you push the bed away from the wall, revealing a ragged hole in the wood paneling.

>l
Children's Bedroom
This must be the children's bedroom. The bed is smaller than the one in the master bedroom, its bright coverlet providing one of the few feeble splashes of color in what must have been, for most of its history, a joylessly Puritan household. A small vanity table occupies the opposite wall, and in the corner under the window stands an ancient crib. The only exit is to the north.

The bed has been pushed away from the wall slightly, revealing a ragged hole in the paneling.

A child's jewelry box sits on the corner of the vanity.

>x hole
You can't see any such thing.

>showme
Children's Bedroom - room
    hole - open container
    yourself - person
        clothes (worn)
        trenchcoat (worn)
        wedding ring (worn)
        keyring - open container
    vanity - supporter
        jewelry box - closed container
            *silver locket - closed container
                *tiny picture
    child's bed
* denotes things which are not in scope

>x hole
You can't see any such thing.

* * *

>move bed
Bracing yourself, you push the bed away from the wall, revealing a ragged hole in the wood paneling.

>x hole
It's about six inches wide, and looks like it was made by by someone breaking in the wall with a hammer and pulling chunks of paneling out with their bare hands

In the hole is a bundle of soggy pages.

>take pages
Taken.

[Your score has just gone up by two points.]

>drop pages
Dropped.

>take pages
Taken.

>x pages
It appears to have been someone's diary. There must have been a leak at some time behind the wall where it was hidden, because most of the pages are water-logged and completely illegible. However, portions of a few entries remain untouched.

>read pages
It appears to have been someone's diary. There must have been a leak at some time behind the wall where it was hidden, because most of the pages are water-logged and completely illegible. However, portions of a few entries remain untouched.

* * *

>take pages
Taken.

[Your score has just gone up by two points.]

>i
You are carrying:
  a bundle of soggy pages
  your clothes (being worn)
  your trenchcoat (being worn)
  your wedding ring (being worn)
  a keyring

>x pages
It appears to have been someone's diary. There must have been a leak at some time behind the wall where it was hidden, because most of the pages are water-logged and completely illegible. However, portions of a few entries remain untouched.

* * *

>take pages
Taken.

[Your score has just gone up by two points.]

>read pages
It appears to have been someone's diary. There must have been a leak at some time behind the wall where it was hidden, because most of the pages are water-logged and completely illegible. However, portions of a few entries remain untouched.

>read pages
It appears to have been someone's diary. There must have been a leak at some time behind the wall where it was hidden, because most of the pages are water-logged and completely illegible. However, portions of a few entries remain untouched.

>search pages
Carefully, you turn the tattered pages. The handwriting is that of a young girl. You idly wonder if this might have been the diary of one of Edward Verlac's daughters -- but then you notice part of a date, just visible in the corner of the page: 1953. This must have been written, then, several years before Edward was born.

The entries that are legible read as follows:

...Father came again to my bed last night... mother doesn't... tells me I can't... to be a good daughter. Sometimes it hurts, but Father always tells me I shouldn't cry. Father says a daughter must do her Duty if she wants to get into Heaven. And I do want to get into Heaven...

(this entry dated 1957) ...my poor little William. Father calls him an aberration, child of the Devil, but I don't believe... locked in the attic. I go to see him whenever Father is away. I sing to him, sometimes, through the keyhole, and slip him sweets through the crack under the door... my baby is beautiful... can't let him hurt my dear baby William... to the doctor, and he has a plan... I can never... this locket, William, and I will always keep yours... to always remember my face...

Nothing else is readable except for one fragmented entry near the very end of the book, the date in the corner reading February 27, 1961:

...dead, but not dead yet... will not allow him to do to Edward what he wanted to do to William... have learned... given him the charm against the... never take it off, dear Edward... (a page has been torn away) ...fear to sleep... mist at the window --

And that's all.

* * *

>s
Children's Bedroom
This must be the children's bedroom. The bed is smaller than the one in the master bedroom, its bright coverlet providing one of the few feeble splashes of color in what must have been, for most of its history, a joylessly Puritan household. A small vanity table occupies the opposite wall, and in the corner under the window stands an ancient crib. The only exit is to the north.

A child's jewelry box sits on the corner of the vanity.

>move bed. x hole. take pages. read it.
Bracing yourself, you push the bed away from the wall, revealing a ragged hole in the wood paneling.

It's about six inches wide, and looks like it was made by by someone breaking in the wall with a hammer and pulling chunks of paneling out with their bare hands

In the hole is a bundle of soggy pages.

Taken.

[Your score has just gone up by two points.]

It appears to have been someone's diary. There must have been a leak at some time behind the wall where it was hidden, because most of the pages are water-logged and completely illegible. However, portions of a few entries remain untouched.

>read pages
It appears to have been someone's diary. There must have been a leak at some time behind the wall where it was hidden, because most of the pages are water-logged and completely illegible. However, portions of a few entries remain untouched.

* * *

>s
Children's Bedroom
This must be the children's bedroom. The bed is smaller than the one in the master bedroom, its bright coverlet providing one of the few feeble splashes of color in what must have been, for most of its history, a joylessly Puritan household. A small vanity table occupies the opposite wall, and in the corner under the window stands an ancient crib. The only exit is to the north.

A child's jewelry box sits on the corner of the vanity.

>n
Upstairs Hall
The shuttered window at the end of the hall throws a gloomy rectangle of light onto the bare wooden floor. Doorways lead north and south.

>s
Children's Bedroom
This must be the children's bedroom. The bed is smaller than the one in the master bedroom, its bright coverlet providing one of the few feeble splashes of color in what must have been, for most of its history, a joylessly Puritan household. A small vanity table occupies the opposite wall, and in the corner under the window stands an ancient crib. The only exit is to the north.

A child's jewelry box sits on the corner of the vanity.

>x bed
Not as fancy as the four-poster, but it looks comfortable enough.

>move bed
Bracing yourself, you push the bed away from the wall, revealing a ragged hole in the wood paneling.

>l
Children's Bedroom
This must be the children's bedroom. The bed is smaller than the one in the master bedroom, its bright coverlet providing one of the few feeble splashes of color in what must have been, for most of its history, a joylessly Puritan household. A small vanity table occupies the opposite wall, and in the corner under the window stands an ancient crib. The only exit is to the north.

A child's jewelry box sits on the corner of the vanity.

>l
Children's Bedroom
This must be the children's bedroom. The bed is smaller than the one in the master bedroom, its bright coverlet providing one of the few feeble splashes of color in what must have been, for most of its history, a joylessly Puritan household. A small vanity table occupies the opposite wall, and in the corner under the window stands an ancient crib. The only exit is to the north.

A child's jewelry box sits on the corner of the vanity.

>move bed
You shove the bed back against the wall, covering the hole.

>l
Children's Bedroom
This must be the children's bedroom. The bed is smaller than the one in the master bedroom, its bright coverlet providing one of the few feeble splashes of color in what must have been, for most of its history, a joylessly Puritan household. A small vanity table occupies the opposite wall, and in the corner under the window stands an ancient crib. The only exit is to the north.

A child's jewelry box sits on the corner of the vanity.

>x hole
You can't see any such thing.

>move bed
Bracing yourself, you push the bed away from the wall, revealing a ragged hole in the wood paneling.

>x hole
You can't see any such thing.

* * *

>s
Children's Bedroom
This must be the children's bedroom. The bed is smaller than the one in the master bedroom, its bright coverlet providing one of the few feeble splashes of color in what must have been, for most of its history, a joylessly Puritan household. A small vanity table occupies the opposite wall, and in the corner under the window stands an ancient crib. The only exit is to the north.

A child's jewelry box sits on the corner of the vanity.

>showme box
(the jewelry box)
jewelry box - closed container
    silver locket - closed container
        tiny picture
location: on the vanity in the Children's Bedroom
unlit, inedible, portable; opaque, closed, openable, unlocked; singular-named, improper-named
description: "It's hardly larger than your hand, made of wood and charmingly decorated with a picture of children dancing around a Maypole. Most likely a plaything of one of the later Verlac children. The lid is closed."
initial appearance: "A child's jewelry box sits on the corner of the vanity."
carrying capacity: 100
printed name: "jewelry box"
printed plural name: "containers"
indefinite article: none
list grouping key: none

>take box
Taken.

>showme box
(the jewelry box)
jewelry box - closed container
    silver locket - closed container
        tiny picture
location: carried by yourself in the Children's Bedroom
unlit, inedible, portable, handled; opaque, closed, openable, unlocked; singular-named, improper-named
description: "It's hardly larger than your hand, made of wood and charmingly decorated with a picture of children dancing around a Maypole. Most likely a plaything of one of the later Verlac children. The lid is closed."
initial appearance: "A child's jewelry box sits on the corner of the vanity."
carrying capacity: 100
printed name: "jewelry box"
printed plural name: "containers"
indefinite article: none
list grouping key: none

>drop box
Dropped.

>showme box
(the jewelry box)
jewelry box - closed container
    silver locket - closed container
        tiny picture
location: in the Children's Bedroom
unlit, inedible, portable, handled; opaque, closed, openable, unlocked; singular-named, improper-named
description: "It's hardly larger than your hand, made of wood and charmingly decorated with a picture of children dancing around a Maypole. Most likely a plaything of one of the later Verlac children. The lid is closed."
initial appearance: "A child's jewelry box sits on the corner of the vanity."
carrying capacity: 100
printed name: "jewelry box"
printed plural name: "containers"
indefinite article: none
list grouping key: none

* * *

>s
Children's Bedroom
This must be the children's bedroom. The bed is smaller than the one in the master bedroom, its bright coverlet providing one of the few feeble splashes of color in what must have been, for most of its history, a joylessly Puritan household. A small vanity table occupies the opposite wall, and in the corner under the window stands an ancient crib. The only exit is to the north.

A child's jewelry box sits on the corner of the vanity.

>x box
It's hardly larger than your hand, made of wood and charmingly decorated with a picture of children dancing around a Maypole. Most likely a plaything of one of the later Verlac children. The lid is closed.

>take it
Taken.

>l
Children's Bedroom
This must be the children's bedroom. The bed is smaller than the one in the master bedroom, its bright coverlet providing one of the few feeble splashes of color in what must have been, for most of its history, a joylessly Puritan household. A small vanity table occupies the opposite wall, and in the corner under the window stands an ancient crib. The only exit is to the north.

>x box
It's hardly larger than your hand, made of wood and charmingly decorated with a picture of children dancing around a Maypole. Most likely a plaything of one of the later Verlac children. The lid is closed.

>open it
It isn't something you can open.

* * *

>take it
Taken.

>open it
You open the jewelry box, revealing a silver locket.

>l
Children's Bedroom
This must be the children's bedroom. The bed is smaller than the one in the master bedroom, its bright coverlet providing one of the few feeble splashes of color in what must have been, for most of its history, a joylessly Puritan household. A small vanity table occupies the opposite wall, and in the corner under the window stands an ancient crib. The only exit is to the north.

>x box
It's hardly larger than your hand, made of wood and charmingly decorated with a picture of children dancing around a Maypole. Most likely a plaything of one of the later Verlac children. The lid is open.

In the jewelry box is a silver locket.

>x locket
It is oval-shaped, held shut with a tiny clasp.

>take it
Taken.

>open it
You open the silver locket, revealing a tiny picture.

>l
Children's Bedroom
This must be the children's bedroom. The bed is smaller than the one in the master bedroom, its bright coverlet providing one of the few feeble splashes of color in what must have been, for most of its history, a joylessly Puritan household. A small vanity table occupies the opposite wall, and in the corner under the window stands an ancient crib. The only exit is to the north.

>i
You are carrying:
  a silver locket (open)
    a tiny picture
  a jewelry box (open but empty)
  your clothes (being worn)
  your trenchcoat (being worn)
  your wedding ring (being worn)
  a keyring

>x picture
The boy in the picture looks no more than three or four years old. He is smiling, but there is something disconcerting about his expression, as though his head were not shaped quite right or his features had been placed slightly wrong. He might possibly have been mentally retarded. It's difficult to tell, because the picture has been cropped so closely you can't even see the edges of the boy's face. Only his features fill the tiny frame.

>take picture
That's fixed in place.

* * *

>e
Upstairs Hall
The shuttered window at the end of the hall throws a gloomy rectangle of light onto the bare wooden floor. Doorways lead north and south.

There is a cord dangling in mid-air here, right about level with your face.

>se
Alley
This narrow aperture between two buildings is nearly blocked with piles of rotting cardboard boxes and overstuffed garbage cans. Ugly, half-crumbling brick walls to either side totter oppressively over you. The alley ends here at a tall, wooden fence.

>e
(first opening the fence)
That's not a thing you can open.

>x fence
One of the boards seems to be loose down at the bottom; you could probably just squeeze through.

>e
Narrow Beach
This narrow strip of beach is tucked away between two outcroppings in the predominantly rocky shoreline, accessible only from a steep, muddy slope to the west. The sand is filthy and strewn with rocks, seaweed, litter and othreer bits of storm-tossed detritus.

Near the bottom of the slope, a sewage outflow pipe juts out over the beach, about three feet above the ground. A thin stream of acrid-smelling sewer water trickles out over the lip of the pipe, forming a puddle in the sand.

>w
Alley
This narrow aperture between two buildings is nearly blocked with piles of rotting cardboard boxes and overstuffed garbage cans. Ugly, half-crumbling brick walls to either side totter oppressively over you. The alley ends here at a tall, wooden fence.

* * *

>e
Upstairs Hall
The shuttered window at the end of the hall throws a gloomy rectangle of light onto the bare wooden floor. Doorways lead north and south.

There is a cord dangling in mid-air here, right about level with your face.

>u
You can't go that way instead.

>pull cord
With a rusty, ratcheting groan and a brief shower of dust, the trap door swings down and folds back, revealing a rickety wooden ladder leading up into darkness.

>l
Upstairs Hall
The shuttered window at the end of the hall throws a gloomy rectangle of light onto the bare wooden floor. Doorways lead north and south.

A rickety wooden ladder stands here, descending from a three-foot by three-foot square of darkness in the ceiling.

>u
The ancient rungs creak alarmingly as you ascend.

Attic
It's much cooler up here than in the rest of the house, and you find it hard to suppress a shiver. Grotesque, looming shadows crawl across the low, slanted ceiling, and the dust hangs thick and motionless in the air. To the west the ceiling dips even lower until the space beneath leaves hardly room enough to crawl, while to the north stands a wooden door, draped in shadows and half-hidden by the slanting eaves.

* * *

>e
Upstairs Hall
The shuttered window at the end of the hall throws a gloomy rectangle of light onto the bare wooden floor. Doorways lead north and south.

There is a cord dangling in mid-air here, right about level with your face.

>unlock door
(with the office door)
(first taking the office door)
That's fixed in place.

>i
You are carrying nothing.

* * *

>e
Upstairs Hall
The shuttered window at the end of the hall throws a gloomy rectangle of light onto the bare wooden floor. Doorways lead north and south.

There is a cord dangling in mid-air here, right about level with your face.

>w
Upstairs Landing
A narrow hallway runs east, from the top of the stairs down the length of the house. To the north, directly opposite the stairs, is the master bedroom.

>s
You can't go that way.

>d
Foyer
Although it appears spacious from the outside, the house's interior feels cramped and gloomy. The walls seem too close together; the ceiling is too high. The doorways, leading in several directions, are narrow and filled with shadows, and the stairs leading up to the second floor are steep and rickety. This is not a house that makes you feel welcome. It is a house that makes you feel tiny and timid, and afraid of dark places. It is a house that makes you feel alone.

Carelessly stacked in a towering heap in the middle of the room are all your luggage and belongings, which you had sent ahead through a moving company before driving up to Massachusetts. Everything you own is boxed away and piled up in the middle of the floor. The reality of this move finally slams home as you stare at the sprawling jumble of stuff, and suddenly you feel very lost and adrift.

Night has now undeniably fallen, and the house is very, very dark. There is probably just enough residual ambience to feel your way upstairs to the bedroom, but the rest of the house is a tenebrous maze of shadows, and any exploring would probably best be done in the morning.

>n
You can't go that way.

* * *

>e
Upstairs Hall
The shuttered window at the end of the hall throws a gloomy rectangle of light onto the bare wooden floor. Doorways lead north and south.

There is a cord dangling in mid-air here, right about level with your face.

>x cord
The cord is about four feet long with a little wooden bob on the end. It appears to be attached to a trap door in the ceiling.

>push it
You bat the cord lightly and watch it swing back and forth for a while.

>pull it
With a rusty, ratcheting groan and a brief shower of dust, the trap door swings down and folds back, revealing a rickety wooden ladder leading up into darkness.

>l
Upstairs Hall
The shuttered window at the end of the hall throws a gloomy rectangle of light onto the bare wooden floor. Doorways lead north and south.

A rickety wooden ladder stands here, descending from a three-foot by three-foot square of darkness in the ceiling.

>u
You can't go that way.

>z
Time passes.

* * *

>e
Upstairs Hall
The shuttered window at the end of the hall throws a gloomy rectangle of light onto the bare wooden floor. Doorways lead north and south.

There is a cord dangling in mid-air here, right about level with your face.

>x door
The door has a glass front with the name of the real estate company -- Benson & Brackhurst -- stenciled across it. The blinds are drawn, the lights are off inside, and no one appears to be home. Odd, since the agent knew you were coming today.

>open door
It seems to be locked.

* * *

>e
Upstairs Hall
The shuttered window at the end of the hall throws a gloomy rectangle of light onto the bare wooden floor. Doorways lead north and south.

There is a cord dangling in mid-air here, right about level with your face.

>z cord
I only understood you as far as wanting to wait.

>x cord
The cord is about four feet long with a little wooden bob on the end. It appears to be attached to a trap door in the ceiling.

>pull it
With a rusty, ratcheting groan and a brief shower of dust, the trap door swings down and folds back, revealing a rickety wooden ladder leading up into darkness.

>l
Upstairs Hall
The shuttered window at the end of the hall throws a gloomy rectangle of light onto the bare wooden floor. Doorways lead north and south.

There is a cord dangling in mid-air here, right about level with your face.

You can also see a ladder here.

>push cord
You bat the cord lightly and watch it swing back and forth for a while.

>take it
That's fixed in place.

>u
(first opening the ladder)
You can't, since the ladder leads nowhere.

* * *

The oldest and strongest emotion of mankind
is fear, and the oldest and strongest kind of
fear is fear of the unknown.

-- H.P. Lovecraft
                                                                                                                                                                                                                                                  I N F O R M H E A D

Please press SPACE to continue.

>e. n.
Upstairs Hall
The shuttered window at the end of the hall throws a gloomy rectangle of light onto the bare wooden floor. Doorways lead north and south.

Library
Whatever else their faults may have been, the Verlacs were evidently not ones to shun the printed word. Books line the walls from floor to ceiling in this dark-paneled, green-carpeted room, interrupted only by doorways to the east and south. A rich, brown leather armchair sits in stately repose near the window, with a polished brass pipe stand nearby completing the picture of some blue-blooded country squire's literary refuge. Once again, you are struck by how easily this place could have been the perfect home.

A beautiful pair of mahogany sliding doors stand closed to the east.

Resting on the pipe stand is a sizable volume decorated with a gilded pentagram on its cover.

>take book. read it.
Taken.

Essentially, it's a textbook on the theory and practice of magickal wards and seals, mystic symbols inscribed on doors and containers in order to keep people and spirits out -- or in. It's all very deliberately vague and arcane (in addition to being written in medieval French and translated into Middle English, making it nearly impossible to understand), the kind of thing that likely got many a scholar burned at the stake in those days.

You are surprised to find that a page in this old and probably quite valuable book has been folded down, as though to mark the place. The section marked discusses various methods of opening doors that have been sealed with the image of a pagan god. Speaking aloud the deity's true name will usually do the trick, apparently.

* * *

The oldest and strongest emotion of mankind
is fear, and the oldest and strongest kind of
fear is fear of the unknown.

-- H.P. Lovecraft
                                                                                                                                                                                                                                                  I N F O R M H E A D

Please press SPACE to continue.

>e. n. take book. x it. read it.
Upstairs Hall
The shuttered window at the end of the hall throws a gloomy rectangle of light onto the bare wooden floor. Doorways lead north and south.

Library
Whatever else their faults may have been, the Verlacs were evidently not ones to shun the printed word. Books line the walls from floor to ceiling in this dark-paneled, green-carpeted room, interrupted only by doorways to the east and south. A rich, brown leather armchair sits in stately repose near the window, with a polished brass pipe stand nearby completing the picture of some blue-blooded country squire's literary refuge. Once again, you are struck by how easily this place could have been the perfect home.

A beautiful pair of mahogany sliding doors stand closed to the east.

Resting on the pipe stand is a sizable volume decorated with a gilded pentagram on its cover.

Taken.

It's an old medieval tome dated in the early 1300s, written by one Galarian Academius desChamps.

Essentially, it's a textbook on the theory and practice of magickal wards and seals, mystic symbols inscribed on doors and containers in order to keep people and spirits out -- or in. It's all very deliberately vague and arcane (in addition to being written in medieval French and translated into Middle English, making it nearly impossible to understand), the kind of thing that likely got many a scholar burned at the stake in those days.

You are surprised to find that a page in this old and probably quite valuable book has been folded down, as though to mark the place. The section marked discusses various methods of opening doors that have been sealed with the image of a pagan god. Speaking aloud the deity's true name will usually do the trick, apparently.

>read book
Essentially, it's a textbook on the theory and practice of magickal wards and seals, mystic symbols inscribed on doors and containers in order to keep people and spirits out -- or in. It's all very deliberately vague and arcane (in addition to being written in medieval French and translated into Middle English, making it nearly impossible to understand), the kind of thing that likely got many a scholar burned at the stake in those days.

You are surprised to find that a page in this old and probably quite valuable book has been folded down, as though to mark the place. The section marked discusses various methods of opening doors that have been sealed with the image of a pagan god. Speaking aloud the deity's true name will usually do the trick, apparently.

>s
Upstairs Hall
The shuttered window at the end of the hall throws a gloomy rectangle of light onto the bare wooden floor. Doorways lead north and south.

>move bed. x hole. take pages. x it. read it.
You can't see any such thing.

>s
Children's Bedroom
This must be the children's bedroom. The bed is smaller than the one in the master bedroom, its bright coverlet providing one of the few feeble splashes of color in what must have been, for most of its history, a joylessly Puritan household. A small vanity table occupies the opposite wall, and in the corner under the window stands an ancient crib. The only exit is to the north.

A child's jewelry box sits on the corner of the vanity.

>move bed. x hole. take pages. x it. read it.
Bracing yourself, you push the bed away from the wall, revealing a ragged hole in the wood paneling.

It's about six inches wide, and looks like it was made by by someone breaking in the wall with a hammer and pulling chunks of paneling out with their bare hands

In the hole is a bundle of soggy pages.

Taken.

[Your score has just gone up by two points.]

It appears to have been someone's diary. There must have been a leak at some time behind the wall where it was hidden, because most of the pages are water-logged and completely illegible. However, portions of a few entries remain untouched.

Carefully, you turn the tattered pages. The handwriting is that of a young girl. You idly wonder if this might have been the diary of one of Edward Verlac's daughters -- but then you notice part of a date, just visible in the corner of the page: 1953. This must have been written, then, several years before Edward was born.

The entries that are legible read as follows:

...Father came again to my bed last night... mother doesn't... tells me I can't... to be a good daughter. Sometimes it hurts, but Father always tells me I shouldn't cry. Father says a daughter must do her Duty if she wants to get into Heaven. And I do want to get into Heaven...

(this entry dated 1957) ...my poor little William. Father calls him an aberration, child of the Devil, but I don't believe... locked in the attic. I go to see him whenever Father is away. I sing to him, sometimes, through the keyhole, and slip him sweets through the crack under the door... my baby is beautiful... can't let him hurt my dear baby William... to the doctor, and he has a plan... I can never... this locket, William, and I will always keep yours... to always remember my face...

Nothing else is readable except for one fragmented entry near the very end of the book, the date in the corner reading February 27, 1961:

...dead, but not dead yet... will not allow him to do to Edward what he wanted to do to William... have learned... given him the charm against the... never take it off, dear Edward... (a page has been torn away) ...fear to sleep... mist at the window --

And that's all.

* * *

The oldest and strongest emotion of mankind
is fear, and the oldest and strongest kind of
fear is fear of the unknown.

-- H.P. Lovecraft
                                                                                                                                                                                                                                                  I N F O R M H E A D

Please press SPACE to continue.

>e. s.
Upstairs Hall
The shuttered window at the end of the hall throws a gloomy rectangle of light onto the bare wooden floor. Doorways lead north and south.

Children's Bedroom
This must be the children's bedroom. The bed is smaller than the one in the master bedroom, its bright coverlet providing one of the few feeble splashes of color in what must have been, for most of its history, a joylessly Puritan household. A small vanity table occupies the opposite wall, and in the corner under the window stands an ancient crib. The only exit is to the north.

A child's jewelry box sits on the corner of the vanity.

>move bed. x hole. take pages. read pages.
Bracing yourself, you push the bed away from the wall, revealing a ragged hole in the wood paneling.

It's about six inches wide, and looks like it was made by by someone breaking in the wall with a hammer and pulling chunks of paneling out with their bare hands

In the hole is a bundle of soggy pages.

Taken.

[Your score has just gone up by two points.]

It appears to have been someone's diary. There must have been a leak at some time behind the wall where it was hidden, because most of the pages are water-logged and completely illegible. However, portions of a few entries remain untouched.

>read pages
It appears to have been someone's diary. There must have been a leak at some time behind the wall where it was hidden, because most of the pages are water-logged and completely illegible. However, portions of a few entries remain untouched.

* * *

The oldest and strongest emotion of mankind
is fear, and the oldest and strongest kind of
fear is fear of the unknown.

-- H.P. Lovecraft
                                                                                                                                                                                                                                                  I N F O R M H E A D

Please press SPACE to continue.

>e. s. move bed. x hole. take pages. read pages.
Upstairs Hall
The shuttered window at the end of the hall throws a gloomy rectangle of light onto the bare wooden floor. Doorways lead north and south.

Children's Bedroom
This must be the children's bedroom. The bed is smaller than the one in the master bedroom, its bright coverlet providing one of the few feeble splashes of color in what must have been, for most of its history, a joylessly Puritan household. A small vanity table occupies the opposite wall, and in the corner under the window stands an ancient crib. The only exit is to the north.

A child's jewelry box sits on the corner of the vanity.

Bracing yourself, you push the bed away from the wall, revealing a ragged hole in the wood paneling.

It's about six inches wide, and looks like it was made by by someone breaking in the wall with a hammer and pulling chunks of paneling out with their bare hands

In the hole is a bundle of soggy pages.

Taken.

[Your score has just gone up by two points.]

It appears to have been someone's diary. There must have been a leak at some time behind the wall where it was hidden, because most of the pages are water-logged and completely illegible. However, portions of a few entries remain untouched.

>consult pages about foo
Carefully, you turn the tattered pages. The handwriting is that of a young girl. You idly wonder if this might have been the diary of one of Edward Verlac's daughters -- but then you notice part of a date, just visible in the corner of the page: 1953. This must have been written, then, several years before Edward was born.

The entries that are legible read as follows:

...Father came again to my bed last night... mother doesn't... tells me I can't... to be a good daughter. Sometimes it hurts, but Father always tells me I shouldn't cry. Father says a daughter must do her Duty if she wants to get into Heaven. And I do want to get into Heaven...

(this entry dated 1957) ...my poor little William. Father calls him an aberration, child of the Devil, but I don't believe... locked in the attic. I go to see him whenever Father is away. I sing to him, sometimes, through the keyhole, and slip him sweets through the crack under the door... my baby is beautiful... can't let him hurt my dear baby William... to the doctor, and he has a plan... I can never... this locket, William, and I will always keep yours... to always remember my face...

Nothing else is readable except for one fragmented entry near the very end of the book, the date in the corner reading February 27, 1961:

...dead, but not dead yet... will not allow him to do to Edward what he wanted to do to William... have learned... given him the charm against the... never take it off, dear Edward... (a page has been torn away) ...fear to sleep... mist at the window --

And that's all.

>n
Upstairs Hall
The shuttered window at the end of the hall throws a gloomy rectangle of light onto the bare wooden floor. Doorways lead north and south.

>n
Library
Whatever else their faults may have been, the Verlacs were evidently not ones to shun the printed word. Books line the walls from floor to ceiling in this dark-paneled, green-carpeted room, interrupted only by doorways to the east and south. A rich, brown leather armchair sits in stately repose near the window, with a polished brass pipe stand nearby completing the picture of some blue-blooded country squire's literary refuge. Once again, you are struck by how easily this place could have been the perfect home.

A beautiful pair of mahogany sliding doors stand closed to the east.

Resting on the pipe stand is a sizable volume decorated with a gilded pentagram on its cover.

* * *

>take book
Taken.

>read book
It's an old medieval tome dated in the early 1300s, written by one Galarian Academius desChamps.

>search book
Essentially, it's a textbook on the theory and practice of magickal wards and seals, mystic symbols inscribed on doors and containers in order to keep people and spirits out -- or in. It's all very deliberately vague and arcane (in addition to being written in medieval French and translated into Middle English, making it nearly impossible to understand), the kind of thing that likely got many a scholar burned at the stake in those days.

You are surprised to find that a page in this old and probably quite valuable book has been folded down, as though to mark the place. The section marked discusses various methods of opening doors that have been sealed with the image of a pagan god. Speaking aloud the deity's true name will usually do the trick, apparently.

* * *

The oldest and strongest emotion of mankind
is fear, and the oldest and strongest kind of
fear is fear of the unknown.

-- H.P. Lovecraft
                                                                                                                                                                                                                                                  I N F O R M H E A D

Please press SPACE to continue.

>e. x ladder.
Upstairs Hall
The shuttered window at the end of the hall throws a gloomy rectangle of light onto the bare wooden floor. Doorways lead north and south.

There is a cord dangling in mid-air here, right about level with your face.

You can also see a ladder here.

The rickety ladder leads up through a square hole in the ceiling. The rungs are slightly crooked and look none too sturdy, but at least none of them are broken.

>u
(first opening the ladder)
You can't, since the ladder leads nowhere.

* * *

The oldest and strongest emotion of mankind
is fear, and the oldest and strongest kind of
fear is fear of the unknown.

-- H.P. Lovecraft
                                                                                                                                                                                                                                                  I N F O R M H E A D

Please press SPACE to continue.

>fetchem
That's not a verb I recognise.

* * *

The oldest and strongest emotion of mankind
is fear, and the oldest and strongest kind of
fear is fear of the unknown.

-- H.P. Lovecraft
                                                                                                                                                                                                                                                  I N F O R M H E A D

Please press SPACE to continue.

>fump
 1  (Arkham Herald, August 12, 1956)
 2  (printed notice)
 3  (London Times, March 3, 1918)
 4  (crumpled flyer)
 5  (obituary)
 6  (Arkham Herald, June 22, 1973)
 7  (Arkham Herald, September 19, 1958)
 8  (photostatic copy)
 9  (Arkham Herald, April 9, 1935)
 A  (Arkham Herald, July 7, 1988)
 B  (announcement)

* * *

The oldest and strongest emotion of mankind
is fear, and the oldest and strongest kind of
fear is fear of the unknown.

-- H.P. Lovecraft
                                                                                                                                                                                                                                                  I N F O R M H E A D

Please press SPACE to continue.

>go2
You wake up. Steam billows gently by, and you can hear the sound of running water coming from the bathroom.

>l
Master Bedroom (on the bed)
The master bedroom is a picture-postcard of rustic New England charm. Faded sketches of rural landscapes adorn the walls; a beautifully carved dressing mirror stands in one corner; an old-fashioned accordion radiator gurgles quietly beneath the window. The most striking feature, an enormous, antique, four-poster bed, must be the largest piece of furniture in the house.

On the four-poster bed you can see Michael's pants.

It's an ordinary-looking key. The word "cellar" is written on a tiny piece of tape affixed to the key's tab.

It's an ordinary-looking key. The word "house" is written on a tiny piece of tape affixed to the key's tab.

An old, discarded tin of fish oil sits at the end of the pier.

Someone has left a flask underneath one of the tables.

You can also see your trenchcoat, your clothes, your keyring (empty) and your umbrella here.

>l
Master Bedroom (on the bed)
The master bedroom is a picture-postcard of rustic New England charm. Faded sketches of rural landscapes adorn the walls; a beautifully carved dressing mirror stands in one corner; an old-fashioned accordion radiator gurgles quietly beneath the window. The most striking feature, an enormous, antique, four-poster bed, must be the largest piece of furniture in the house.

On the four-poster bed you can see Michael's pants.

It's an ordinary-looking key. The word "cellar" is written on a tiny piece of tape affixed to the key's tab.

It's an ordinary-looking key. The word "house" is written on a tiny piece of tape affixed to the key's tab.

An old, discarded tin of fish oil sits at the end of the pier.

Someone has left a flask underneath one of the tables.

You can also see your trenchcoat, your clothes, your keyring (empty) and your umbrella here.

* * *

>take clothes
You put on the clothes.

I beg your pardon?

>e
You can't go that way.

>s
Upstairs Landing
A narrow hallway runs east, from the top of the stairs down the length of the house. To the north, directly opposite the stairs, is the master bedroom.

>e
Upstairs Hall
The shuttered window at the end of the hall throws a gloomy rectangle of light onto the bare wooden floor. Doorways lead north and south.

There is a cord dangling in mid-air here, right about level with your face

>push cord
You bat the cord lightly and watch it swing back and forth for a while.

>pull cord
With a rusty, ratcheting groan and a brief shower of dust, the trap door swings down and folds back, revealing a rickety wooden ladder leading up into darkness.

>l
Upstairs Hall
The shuttered window at the end of the hall throws a gloomy rectangle of light onto the bare wooden floor. Doorways lead north and south.

Foo.

* * *

>go2
You wake up. Steam billows gently by, and you can hear the sound of running water coming from the bathroom.

>stand. dress. s. e.
You get off the bed.

Master Bedroom
The master bedroom is a picture-postcard of rustic New England charm. Faded sketches of rural landscapes adorn the walls; a beautifully carved dressing mirror stands in one corner; an old-fashioned accordion radiator gurgles quietly beneath the window. The most striking feature, an enormous, antique, four-poster bed, must be the largest piece of furniture in the house.

On the four-poster bed you can see Michael's pants.

Someone has left a flask underneath one of the tables.

An old, discarded tin of fish oil sits at the end of the pier.

You can also see your trenchcoat, your clothes, your keyring (empty), your umbrella, a house key and a cellar key here.

That's not a verb I recognise.

>u
You can't go that way.

>s. e.
Shouldn't you dress first?

You can't go that way.

>take clothes.
You put on the clothes.

>s. e.
Upstairs Landing
A narrow hallway runs east, from the top of the stairs down the length of the house. To the north, directly opposite the stairs, is the master bedroom.

Upstairs Hall
The shuttered window at the end of the hall throws a gloomy rectangle of light onto the bare wooden floor. Doorways lead north and south.

There is a cord dangling in mid-air here, right about level with your face

>u
(first opening the attic ladder)
It isn't something you can open.

* * *

>go2
You wake up. Steam billows gently by, and you can hear the sound of running water coming from the bathroom.

>stand. take clothes. s. e.
You get off the bed.

Master Bedroom
The master bedroom is a picture-postcard of rustic New England charm. Faded sketches of rural landscapes adorn the walls; a beautifully carved dressing mirror stands in one corner; an old-fashioned accordion radiator gurgles quietly beneath the window. The most striking feature, an enormous, antique, four-poster bed, must be the largest piece of furniture in the house.

On the four-poster bed you can see Michael's pants.

Someone has left a flask underneath one of the tables.

An old, discarded tin of fish oil sits at the end of the pier.

You can also see your trenchcoat, your clothes, your keyring (empty), your umbrella, a house key and a cellar key here.

You put on the clothes.

Upstairs Landing
A narrow hallway runs east, from the top of the stairs down the length of the house. To the north, directly opposite the stairs, is the master bedroom.

Upstairs Hall
The shuttered window at the end of the hall throws a gloomy rectangle of light onto the bare wooden floor. Doorways lead north and south.

There is a cord dangling in mid-air here, right about level with your face

>pull cord
With a rusty, ratcheting groan and a brief shower of dust, the trap door swings down and folds back, revealing a rickety wooden ladder leading up into darkness.

* * *

>l
Upstairs Hall
The shuttered window at the end of the hall throws a gloomy rectangle of light onto the bare wooden floor. Doorways lead north and south.

A rickety wooden ladder stands here, descending from a three-foot by three-foot square of darkness in the ceiling.

>u
The ancient rungs creak alarmingly as you ascend.

Attic
It's much cooler up here than in the rest of the house, and you find it hard to suppress a shiver. Grotesque, looming shadows crawl across the low, slanted ceiling, and the dust hangs thick and motionless in the air. To the west the ceiling dips even lower until the space beneath leaves hardly room enough to crawl, while to the north stands a wooden door, draped in shadows and half-hidden by the slanting eaves.

Bar.

>restore
Restore failed.

>restart
Are you sure you want to restart?

>yes
Informhead
An Interactive Fiction by Ed Peters
Release 1 / Serial number 230531 / Inform 7 v10.1.2 / D

Outside the Real Estate Office
A grim little cul-de-sac, tucked away in a corner of the claustrophobic tangle of narrow, twisting avenues that largely constitute the older portion of Anchorhead. Like most of the streets in this city, it is ancient, shadowy, and leads essentially nowhere. The lane ends here at the real estate agent's office, which lies to the east, and winds its way back toward the center of town to the west. A narrow, garbage-choked alley opens to the southeast.

>go2
You wake up. Steam billows gently by, and you can hear the sound of running water coming from the bathroom.

* * *

>u
(first opening the attic ladder)
It isn't something you can open.

* * *

The oldest and strongest emotion of mankind
is fear, and the oldest and strongest kind of
fear is fear of the unknown.

-- H.P. Lovecraft
                                                                                                                                                                                                                                                  I N F O R M H E A D

Please press SPACE to continue.

>go2. stand. take clothes. s. e. u.
You wake up. Steam billows gently by, and you can hear the sound of running water coming from the bathroom.

You get off the bed.

Master Bedroom
The master bedroom is a picture-postcard of rustic New England charm. Faded sketches of rural landscapes adorn the walls; a beautifully carved dressing mirror stands in one corner; an old-fashioned accordion radiator gurgles quietly beneath the window. The most striking feature, an enormous, antique, four-poster bed, must be the largest piece of furniture in the house.

On the four-poster bed you can see Michael's pants.

Someone has left a flask underneath one of the tables.

An old, discarded tin of fish oil sits at the end of the pier.

You can also see your trenchcoat, your clothes, your keyring (empty), your umbrella, a house key and a cellar key here.

You put on the clothes.

Upstairs Landing
A narrow hallway runs east, from the top of the stairs down the length of the house. To the north, directly opposite the stairs, is the master bedroom.

Upstairs Hall
The shuttered window at the end of the hall throws a gloomy rectangle of light onto the bare wooden floor. Doorways lead north and south.

There is a cord dangling in mid-air here, right about level with your face

(first opening the attic ladder)
You pull the cord. With a rusty, ratcheting groan and a brief shower of dust, the trap door swings down and folds back, revealing a rickety wooden ladder leading up into darkness.

The ancient rungs creak alarmingly as you ascend.

Attic
It's much cooler up here than in the rest of the house, and you find it hard to suppress a shiver. Grotesque, looming shadows crawl across the low, slanted ceiling, and the dust hangs thick and motionless in the air. To the west the ceiling dips even lower until the space beneath leaves hardly room enough to crawl, while to the north stands a wooden door, draped in shadows and half-hidden by the slanting eaves.

Bar.

* * *

The oldest and strongest emotion of mankind
is fear, and the oldest and strongest kind of
fear is fear of the unknown.

-- H.P. Lovecraft
                                                                                                                                                                                                                                                  I N F O R M H E A D

Please press SPACE to continue.

>go3
You wake up, shivering. Michael is in bed next to you, sleeping like a dead man with the sheets wrapped in a twisted snarl around his body.

>stand
You get off the bed.

Master Bedroom
The master bedroom is a picture-postcard of rustic New England charm. Faded sketches of rural landscapes adorn the walls; a beautifully carved dressing mirror stands in one corner; an old-fashioned accordion radiator gurgles quietly beneath the window. The most striking feature, an enormous, antique, four-poster bed, must be the largest piece of furniture in the house.

You can see your trenchcoat, your clothes, your keyring (empty), your umbrella, a house key, a cellar key, a small copper key, an old-fashioned iron key and a strange black disk here.

>ake all
That's not a verb I recognise.

>take all
trenchcoat: You put on the trenchcoat.
clothes: You put on the clothes.
keyring: You take the keyring. .
umbrella: You take the umbrella. It's olive green, with a hook-shaped handle. A handy little thing, when it rains. It's currently closed..
house key: You take the house key. It's an ordinary-looking key. The word "house" is written on a tiny piece of tape affixed to the key's tab..
cellar key: You take the cellar key. It's an ordinary-looking key. The word "cellar" is written on a tiny piece of tape affixed to the key's tab..
small copper key: You take the small copper key. "Mine!" the old man hisses, clapping his hands onto his chest as though you were about to frisk him for it. "It's mine, and I won't let it go!".
old-fashioned iron key: strange black disk: You take the strange black disk. It's a dark, glassy circle, about the width of your hand in diameter and half an inch thick in the middle, tapering off to thinness toward the edge like a convex lens. Its color is the deep, oily black of obsidian, though you fancy you can see faint swirls of color inside it like the rainbow sheen of oil on water. Its curved surface is cool and perfectly smooth. Although incredibly hard, the material does not feel like stone; there is an odd, yielding quality to it, almost like something organic... almost, you realize with disquiet, like skin..

[Your score has just gone up by one point.]

>s. e. n.
Upstairs Landing
A narrow hallway runs east, from the top of the stairs down the length of the house. To the north, directly opposite the stairs, is the master bedroom.

Upstairs Hall
The shuttered window at the end of the hall throws a gloomy rectangle of light onto the bare wooden floor. Doorways lead north and south.

There is a cord dangling in mid-air here, right about level with your face.

Library
Whatever else their faults may have been, the Verlacs were evidently not ones to shun the printed word. Books line the walls from floor to ceiling in this dark-paneled, green-carpeted room, interrupted only by doorways to the east and south. A rich, brown leather armchair sits in stately repose near the window, with a polished brass pipe stand nearby completing the picture of some blue-blooded country squire's literary refuge. Once again, you are struck by how easily this place could have been the perfect home.

A beautiful pair of mahogany sliding doors stand closed to the east.

Resting on the pipe stand is a sizable volume decorated with a gilded pentagram on its cover.

>e
(first opening the mahogany doors)

Study
This smaller room adjoining the library seems comfortable enough, although it is dusty and cluttered from having not been lived in for the better part of a year. Aside from the desk and the chair and the empty shelves, the only real feature of the room is the large, ornate fireplace in the southern wall.

A beautiful pair of mahogany sliding doors stand open to the west.

Michael's laptop sits in the middle of the desk, humming quietly to itself.

On Michael's desk is a letter opener.

>showme doors
(the mahogany doors)
mahogany doors - open door
location: in Study
unlit, inedible, fixed in place; open, openable, unlocked; plural-named, improper-named
description: "Each door is carved from a single piece of mahogany, and polished to a deep, rich shine. The doors are open."
initial appearance: "A beautiful pair of mahogany sliding doors stand open to the west."
last turn examined: -2
printing: "blank"
leading-through destination: <routine 261738>
printed name: "mahogany doors"
printed plural name: "doors"
indefinite article: none
list grouping key: none

>l
Study
This smaller room adjoining the library seems comfortable enough, although it is dusty and cluttered from having not been lived in for the better part of a year. Aside from the desk and the chair and the empty shelves, the only real feature of the room is the large, ornate fireplace in the southern wall.

A beautiful pair of mahogany sliding doors stand open to the west.

Michael's laptop sits in the middle of the desk, humming quietly to itself.

On Michael's desk is a letter opener.

* * *

>e
(first opening the mahogany doors)

Study
This smaller room adjoining the library seems comfortable enough, although it is dusty and cluttered from having not been lived in for the better part of a year. Aside from the desk and the chair and the empty shelves, the only real feature of the room is the large, ornate fireplace in the southern wall.

A beautiful pair of mahogany sliding doors stand open to the west.

Michael's laptop sits in the middle of the desk, humming quietly to itself.

On Michael's desk is a letter opener.

>x laptop
A top-of-the-line model: it's sleek, lightweight and very fast, a real status symbol for the writer who wants to look as though he might stop whatever he's doing at the drop of a hat and suddenly hack out a bestseller. While you have yet to witness Michael do this, he really had been wanting one since before the two of you even met; so, to celebrate his new teaching position, you splurged and bought him one.

>x letter opener
It's a rather ornate thing, with a silver hilt and a slim, sharp tip.

>take it
You take the letter opener.

>l
Study
This smaller room adjoining the library seems comfortable enough, although it is dusty and cluttered from having not been lived in for the better part of a year. Aside from the desk and the chair and the empty shelves, the only real feature of the room is the large, ornate fireplace in the southern wall.

A beautiful pair of mahogany sliding doors stand closed to the west.

Michael's laptop sits in the middle of the desk, humming quietly to itself.

>x laptop
A top-of-the-line model: it's sleek, lightweight and very fast, a real status symbol for the writer who wants to look as though he might stop whatever he's doing at the drop of a hat and suddenly hack out a bestseller. While you have yet to witness Michael do this, he really had been wanting one since before the two of you even met; so, to celebrate his new teaching position, you splurged and bought him one.

>x screen
The computer is in screen-saver mode: blank except for a single window requesting a 4-digit user passcode. Odd; you didn't think Michael ever used the passcode utility.

>read laptop
The computer is in screen-saver mode: blank except for a single window requesting a 4-digit user passcode. Odd; you didn't think Michael ever used the passcode utility.

>x desk
It's an ordinary writing desk with a small drawer, which is closed.

On Michael's desk is a laptop.

>x drawer
You see nothing special about Michael's drawer.

>open it
You open Michael's drawer, revealing a Cryptical Haermoniacon.

>read book
You can't see any such thing.

* * *

>stand
You get off the bed.

Master Bedroom
The master bedroom is a picture-postcard of rustic New England charm. Faded sketches of rural landscapes adorn the walls; a beautifully carved dressing mirror stands in one corner; an old-fashioned accordion radiator gurgles quietly beneath the window. The most striking feature, an enormous, antique, four-poster bed, must be the largest piece of furniture in the house.

You can see your trenchcoat, your clothes, your keyring (empty), your umbrella, a house key, a cellar key, a small copper key, an old-fashioned iron key and a strange black disk here.

>take all
trenchcoat: You put on the trenchcoat.
clothes: You put on the clothes.
keyring: You take the keyring. .
umbrella: You take the umbrella. It's olive green, with a hook-shaped handle. A handy little thing, when it rains. It's currently closed..
house key: You take the house key. It's an ordinary-looking key. The word "house" is written on a tiny piece of tape affixed to the key's tab..
cellar key: You take the cellar key. It's an ordinary-looking key. The word "cellar" is written on a tiny piece of tape affixed to the key's tab..
small copper key: You take the small copper key. "Mine!" the old man hisses, clapping his hands onto his chest as though you were about to frisk him for it. "It's mine, and I won't let it go!".
old-fashioned iron key: strange black disk: You take the strange black disk. It's a dark, glassy circle, about the width of your hand in diameter and half an inch thick in the middle, tapering off to thinness toward the edge like a convex lens. Its color is the deep, oily black of obsidian, though you fancy you can see faint swirls of color inside it like the rainbow sheen of oil on water. Its curved surface is cool and perfectly smooth. Although incredibly hard, the material does not feel like stone; there is an odd, yielding quality to it, almost like something organic... almost, you realize with disquiet, like skin..

[Your score has just gone up by one point.]

>s. e.
Upstairs Landing
A narrow hallway runs east, from the top of the stairs down the length of the house. To the north, directly opposite the stairs, is the master bedroom.

Upstairs Hall
The shuttered window at the end of the hall throws a gloomy rectangle of light onto the bare wooden floor. Doorways lead north and south.

There is a cord dangling in mid-air here, right about level with your face.

>n
Library
Whatever else their faults may have been, the Verlacs were evidently not ones to shun the printed word. Books line the walls from floor to ceiling in this dark-paneled, green-carpeted room, interrupted only by doorways to the east and south. A rich, brown leather armchair sits in stately repose near the window, with a polished brass pipe stand nearby completing the picture of some blue-blooded country squire's literary refuge. Once again, you are struck by how easily this place could have been the perfect home.

A beautiful pair of mahogany sliding doors stand closed to the east.

Resting on the pipe stand is a sizable volume decorated with a gilded pentagram on its cover.

>x doors
Each door is carved from a single piece of mahogany, and polished to a deep, rich shine. The doors are closed.

>open doors
You open the mahogany doors.

>l
Library
Whatever else their faults may have been, the Verlacs were evidently not ones to shun the printed word. Books line the walls from floor to ceiling in this dark-paneled, green-carpeted room, interrupted only by doorways to the east and south. A rich, brown leather armchair sits in stately repose near the window, with a polished brass pipe stand nearby completing the picture of some blue-blooded country squire's literary refuge. Once again, you are struck by how easily this place could have been the perfect home.

A beautiful pair of mahogany sliding doors stand closed to the east.

Resting on the pipe stand is a sizable volume decorated with a gilded pentagram on its cover.

>e
You can't, since the mahogany doors lead nowhere.

>open doors
They're already open.

I beg your pardon?

>l
Library
Whatever else their faults may have been, the Verlacs were evidently not ones to shun the printed word. Books line the walls from floor to ceiling in this dark-paneled, green-carpeted room, interrupted only by doorways to the east and south. A rich, brown leather armchair sits in stately repose near the window, with a polished brass pipe stand nearby completing the picture of some blue-blooded country squire's literary refuge. Once again, you are struck by how easily this place could have been the perfect home.

A beautiful pair of mahogany sliding doors stand closed to the east.

Resting on the pipe stand is a sizable volume decorated with a gilded pentagram on its cover.

>showme doors
(the mahogany doors)
mahogany doors - open door
location: in Library
unlit, inedible, fixed in place; open, openable, unlocked; plural-named, improper-named
description: "Each door is carved from a single piece of mahogany, and polished to a deep, rich shine. The doors are open."
initial appearance: "A beautiful pair of mahogany sliding doors stand closed to the east."
last turn examined: 7
printing: "blank"
printed name: "mahogany doors"
printed plural name: "doors"
indefinite article: none
list grouping key: none

>l
Library
Whatever else their faults may have been, the Verlacs were evidently not ones to shun the printed word. Books line the walls from floor to ceiling in this dark-paneled, green-carpeted room, interrupted only by doorways to the east and south. A rich, brown leather armchair sits in stately repose near the window, with a polished brass pipe stand nearby completing the picture of some blue-blooded country squire's literary refuge. Once again, you are struck by how easily this place could have been the perfect home.

A beautiful pair of mahogany sliding doors stand closed to the east.

Resting on the pipe stand is a sizable volume decorated with a gilded pentagram on its cover.

* * *

>e
(first opening the mahogany doors)

Study
This smaller room adjoining the library seems comfortable enough, although it is dusty and cluttered from having not been lived in for the better part of a year. Aside from the desk and the chair and the empty shelves, the only real feature of the room is the large, ornate fireplace in the southern wall.

A beautiful pair of mahogany sliding doors stand open to the west.

On Michael's desk are a letter opener and a laptop.

>x chair
It's just a straight-backed wooden chair.

>sit on chair
It's a bit spartan for your tastes. Michael likes his writing chairs to be very slightly uncomfortable, so that he can't doze off.

>stand
You get off the wooden chair.

Study
This smaller room adjoining the library seems comfortable enough, although it is dusty and cluttered from having not been lived in for the better part of a year. Aside from the desk and the chair and the empty shelves, the only real feature of the room is the large, ornate fireplace in the southern wall.

A beautiful pair of mahogany sliding doors stand closed to the west.

Michael's laptop sits in the middle of the desk, humming quietly to itself.

On Michael's desk is a letter opener.

>show doors
(to yourself)
(first taking the mahogany doors)
They're fixed in place.

>showme doors
(the mahogany doors)
mahogany doors - open door
location: in Study
unlit, inedible, fixed in place; open, openable, unlocked; plural-named, improper-named
description: "Each door is carved from a single piece of mahogany, and polished to a deep, rich shine. The doors are open."
initial appearance: "A beautiful pair of mahogany sliding doors stand closed to the west."
last turn examined: -2
printing: "blank"
leading-through destination: <routine 261738>
printed name: "mahogany doors"
printed plural name: "doors"
indefinite article: none
list grouping key: none

* * *

>e
(first opening the mahogany doors)

Study
This smaller room adjoining the library seems comfortable enough, although it is dusty and cluttered from having not been lived in for the better part of a year. Aside from the desk and the chair and the empty shelves, the only real feature of the room is the large, ornate fireplace in the southern wall.

A beautiful pair of mahogany sliding doors stand open to the west.

On Michael's desk are a letter opener and a laptop.

>x laptop
A top-of-the-line model: it's sleek, lightweight and very fast, a real status symbol for the writer who wants to look as though he might stop whatever he's doing at the drop of a hat and suddenly hack out a bestseller. While you have yet to witness Michael do this, he really had been wanting one since before the two of you even met; so, to celebrate his new teaching position, you splurged and bought him one.

* * *

>e
(first opening the mahogany doors)

Study
This smaller room adjoining the library seems comfortable enough, although it is dusty and cluttered from having not been lived in for the better part of a year. Aside from the desk and the chair and the empty shelves, the only real feature of the room is the large, ornate fireplace in the southern wall.

A beautiful pair of mahogany sliding doors stand open to the west.

On Michael's desk are a letter opener and a laptop.

>x laptop
A top-of-the-line model: it's sleek, lightweight and very fast, a real status symbol for the writer who wants to look as though he might stop whatever he's doing at the drop of a hat and suddenly hack out a bestseller. While you have yet to witness Michael do this, he really had been wanting one since before the two of you even met; so, to celebrate his new teaching position, you splurged and bought him one.

The laptop is currently switched on.

>type
I didn't understand that sentence.

>type foo
The computer beeps at you. "ACCESS DENIED". Frustrated, you wonder what Michael could have set his password to. An important date, maybe?

>read screen
Nothing is written on the screen.

>x screen
The computer is in screen-saver mode: blank except for a single window requesting a 4-digit user passcode. Odd; you didn't think Michael ever used the passcode utility.

* * *

The oldest and strongest emotion of mankind
is fear, and the oldest and strongest kind of
fear is fear of the unknown.

-- H.P. Lovecraft
                                                                                                                                                                                                                                                  I N F O R M H E A D

Please press SPACE to continue.

>i
You are carrying:
  A Historical Overview of Superstitions by J. Arnsworth Frazer
  a puzzle box
  your clothes (being worn)
  your trenchcoat (being worn)
  your wedding ring (being worn)
  your umbrella
  your keyring

>clean clothes with keyring
It doesn't get much cleaner.

* * *

>i
You are carrying:
  a flashlight (providing light)
  a cellar key
  a house key
  your keyring
  Michael's faculty card
  your clothes (being worn)
  your trenchcoat (being worn)
  your wedding ring (being worn)

>u
Pantry
The pantry is empty save for a layer of dust on the shelves. A door to the south leads down to the cellar, or you can return to the kitchen to the southeast.

Leaning in the corner is an old broom.

>take broom
Taken.

>d
Cellar
The old, flagstone walls gleam with unwholesome-smelling moisture, and the sagging timbers creak uneasily above your head. Ancient, frayed wiring festoons the ceiling like some strange species of clinging vine. Portions of the cellar extend south and east into the clammy darkness, though you could always beat a hasty retreat up the stairs to the north.

One largish bundle of wires leads down to a rusty old fuse cabinet bolted to the far wall.

>i broom
I only understood you as far as wanting to take inventory.

>x broom
It's just an ordinary-looking broom.

>s
Storage Room
Old crates and boxes piled high against the walls make this room seem even smaller and dingier than it actually is, which is saying a lot. A doorway lies north; the other walls contain nothing but shadows and dirt-filled corners.

>clean web with keyring
You can't see any such thing.

>search crates. x web.
You spend some time poking dispiritedly through boxes of second-hand table settings, discarded shoes and outdated encyclopedias, but the only thing you manage to dig up is an old cardboard box full of newspaper clippings, which might make interesting reading later if you can find the time. The only thing at all noteworthy about the room, in fact, is that it desperately wants cleaning; there's even a big, nasty-looking spider web in a corner behind one of the crates.

Not a pretty, symmetrical spiral web like you see in nature magazines; this is a tangled, ugly mass of dull gray threads spun in every direction, the work of some careless, inebriated arachnid on a weekend binger. Way back in the corner, almost buried beneath the disheveled strands, is an old-fashioned iron key.

>clean web with keyring
The spider web wouldn't be very effective.

>clean web with umbrella
You can't see any such thing.

* * *

>i
You are carrying:
  A Historical Overview of Superstitions by J. Arnsworth Frazer
  a puzzle box
  your clothes (being worn)
  your trenchcoat (being worn)
  your wedding ring (being worn)
  your umbrella
  your keyring

>w
Narrow Street
As the lane winds along from east to west, it narrows until the steep, jagged rooftops on either side of the street practically touch each other. To the south, a side street leads across Whateley Bridge toward the center of town, and a twisting lane leads up a hill to the northwest. A short flight of steps to the north leads down to the local watering hole.

A sudden gust of wind blows a cold spray of rain into your face.

>nw
Twisting Lane
The lane narrows here to little more than a badly cobbled sidewalk as it wends its way up through a series of tortuous bends and switchbacks. In some places, the street is so steep that steps have been cut into it, worn down over the years and slick with moss. Your progress is blocked at the top of the street by a brick wall.

Someone has sprayed graffiti across the wall in black spray paint.

>w
Hidden Court
You had no idea this little courtyard even existed, cleverly tucked away amidst the confusing tangle of darker avenues. Although surrounded on all sides by steep rooftops and overshadowed by the ever- ominous clouds, this secluded circle somehow manages to convey a sense of peace and brightness, a safe harbor from the oppressive gloom pervading the rest of the town. To the south, a hanging sign marks a humble shop, while a sidestreet to the east leads back into the labyrinth.

>s
A silvery bell jingles as you open the door.

Cauldron
A warm and pleasantly dim light surrounds you and suffuses this cozy little shop. The shelves are crammed with every conceivable variety of new age curiosity: books, crystals, pendants, charms, herbs, potions, incense, candles and -- sure enough, on a display stand right near the door -- decorative cast-iron cauldron-shaped paperweights. How cute. In the rear of the store, a lit display case contains several items of interest. The courtyard lies outside, to the north.

On the display case is a violin.

The proprietor watches you quietly from behind the display case.

>give puzzle box to proprietor
The proprietor doesn't seem interested.

* * *

>i
You are carrying:
  A Historical Overview of Superstitions by J. Arnsworth Frazer
  a puzzle box
  your clothes (being worn)
  your trenchcoat (being worn)
  your wedding ring (being worn)
  your umbrella
  your keyring

>x frazer
A thick and weighty tome, its full title is A Historical Overview of Superstitions in the Miskaton Valley Region by J. Arnsworth Frazer, published in 1906. It begins: "Although New England has always been an abundant storehouse of American myth and folklore, the Miskaton River Valley has long been recognized as particularly fecund ground for tall tales and fanciful superstition. Legends abound of hideous, inhuman races living within the venerable hills; of pagan rituals enacted at unholy burial grounds and dedicated to ancient, blasphemous gods..." and continues along the same lines in the typically dry and bombastic style of those times.

>read it
As you open the book, a slip of paper falls from its pages and flutters to the ground.

>l
Outside the Real Estate Office
A grim little cul-de-sac, tucked away in a corner of the claustrophobic tangle of narrow, twisting avenues that largely constitute the older portion of Anchorhead. Like most of the streets in this city, it is ancient, shadowy, and leads essentially nowhere. The lane ends here at the real estate agent's office, which lies to the east, and winds its way back toward the center of town to the west. A narrow, garbage-choked alley opens to the southeast.

You can see a slip of paper here.

>x paper
Someone was apparently using it as a bookmark. There's some writing on one side.

>read it
It says:  born-died same date? have to chk. records  The handwriting is unmistakably Michael's.

* * *

>i
You are carrying:
  A Historical Overview of Superstitions by J. Arnsworth Frazer
  a puzzle box
  your clothes (being worn)
  your trenchcoat (being worn)
  your wedding ring (being worn)
  your umbrella
  your keyring

>x keyring
The keyring is empty.

* * *

The oldest and strongest emotion of mankind
is fear, and the oldest and strongest kind of
fear is fear of the unknown.

-- H.P. Lovecraft
                                                                                                                                                                                                                                                  I N F O R M H E A D

Please press SPACE to continue.

>lean on wall
That's not a verb I recognise.

* * *

The oldest and strongest emotion of mankind
is fear, and the oldest and strongest kind of
fear is fear of the unknown.

-- H.P. Lovecraft
                                                                                                                                                                                                                                                  I N F O R M H E A D

Please press SPACE to continue.

>lock office door
That's locked at the moment.

The clouds overhead mutter restlessly to themselves.

* * *

The oldest and strongest emotion of mankind
is fear, and the oldest and strongest kind of
fear is fear of the unknown.

-- H.P. Lovecraft
                                                                                                                                                                                                                                                  I N F O R M H E A D

Please press SPACE to continue.

>look up foo
I only understood you as far as wanting to look up something.

>look up foo in records
The records don't seem to contain anything about foo.

>look up wilhelm in records
Wilhelm Verlac: born March 11, 1651..

* * *

The oldest and strongest emotion of mankind
is fear, and the oldest and strongest kind of
fear is fear of the unknown.

-- H.P. Lovecraft
                                                                                                                                                                                                                                                  I N F O R M H E A D

Please press SPACE to continue.

>lookup wilhelm
That's not a verb I recognise.

>consult records about wilhelm
The records don't seem to contain anything about wilhelm.

>consult records about heinrich
The records don't seem to contain anything about heinrich.

* * *

>lookup wilhelm
That's not a verb I recognise.

>lookup wilhelm in records
That's not a verb I recognise.

>look up wilhelm in records
Wilhelm Verlac: died October 18, 1734..

>ne. se.
Courthouse Basement
A single bulb dangling from the ceiling casts a watery, yellow light against the brick walls. A rickety staircase to the north leads back up to the ground floor, and two narrow doorways lead into the record archives. Over the southeast door hangs a sign that reads "BIRTH RECORDS", while the southwest door bears the sign "DEATH RECORDS".

Birth Records
A bare room with cinderblock walls. Thousands of records and documents, most yellow and brittle with age, are stacked everywhere in towering piles. The exit lies northwest.

>look up wilhelm in records
Wilhelm Verlac: born March 11, 1651..

* * *

The oldest and strongest emotion of mankind
is fear, and the oldest and strongest kind of
fear is fear of the unknown.

-- H.P. Lovecraft
                                                                                                                                                                                                                                                  I N F O R M H E A D

Please press SPACE to continue.

>open pants
They aren't something you can open.

>look in pants
Michael's pants are empty.

* * *

The oldest and strongest emotion of mankind
is fear, and the oldest and strongest kind of
fear is fear of the unknown.

-- H.P. Lovecraft
                                                                                                                                                                                                                                                  I N F O R M H E A D

Please press SPACE to continue.

>read frazer
As you open the book, a slip of paper falls from its pages and flutters to the ground.

>read frazer
 1  Introduction
 2  The Legend of Croseus Verlac
 3  Rituals of the Misquat Indians
 4  The Dark Man and Other Aspects
 5  The "Strangling Mist" Legend
 6  The "Ghost Train" Legend

* * *

The oldest and strongest emotion of mankind
is fear, and the oldest and strongest kind of
fear is fear of the unknown.

-- H.P. Lovecraft
                                                                                                                                                                                                                                                  I N F O R M H E A D

Please press SPACE to continue.

>remove clothes
You take off the clothes.

>drop them
I'm not sure what 'them' refers to.

>drop clothes
Dropped.

>i
You are carrying:
  your trenchcoat (being worn)
  your wedding ring (being worn)
  a keyring

>take clothes
You put on the clothes.

>drop trenchcoat
(first taking the trenchcoat off)
Dropped.

>take trenchcoat
You put on the trenchcoat.

>i
You are carrying:
  your trenchcoat (being worn)
  your clothes (being worn)
  your wedding ring (being worn)
  a keyring

* * *

The oldest and strongest emotion of mankind
is fear, and the oldest and strongest kind of
fear is fear of the unknown.

-- H.P. Lovecraft
                                                                                                                                                                                                                                                  I N F O R M H E A D

Please press SPACE to continue.

>restore
Restore failed.

* * *

>restart
Are you sure you want to restart?

>y
Informhead
An Interactive Fiction by Ed Peters
Release 1 / Serial number 230530 / Inform 7 v10.1.2 / D

Outside the Real Estate Office
A grim little cul-de-sac, tucked away in a corner of the claustrophobic tangle of narrow, twisting avenues that largely constitute the older portion of Anchorhead. Like most of the streets in this city, it is ancient, shadowy, and leads essentially nowhere. The lane ends here at the real estate agent's office, which lies to the east, and winds its way back toward the center of town to the west. A narrow, garbage-choked alley opens to the southeast.

* * *

>s
(first getting off the bed)

Upstairs Landing
A narrow hallway runs east, from the top of the stairs down the length of the house. To the north, directly opposite the stairs, is the master bedroom.

>e
Upstairs Hall
The shuttered window at the end of the hall throws a gloomy rectangle of light onto the bare wooden floor. Doorways lead north and south.

There is a cord dangling in mid-air here, right about level with your face.

>n
You pause as the shower shuts off, and you hear Michael moving around in the next room. His footsteps thump loudly on the hardwood floor as he comes down the hall, and then are muffled again as he steps onto the deep green carpet of the library.

"Good morning," he says, smiling and kissing you lightly on the cheek. He looks around at the crowded rows of books. "Neat, huh? I may go through some of them this morning. Since the fogies don't need me to start work until tomorrow, I thought I'd stay home and try to get some writing done."

As he steps through the sliding doors into the study, he turns and says, "I'll be in here for a while, okay? Oh, and if you go out today, see if you can find a newspaper somewhere." He smiles as he slides the doors shut.

* * *

The oldest and strongest emotion of mankind
is fear, and the oldest and strongest kind of
fear is fear of the unknown.

-- H.P. Lovecraft
                                                                                                                                                                                                                                                  I N F O R M H E A D

Please press SPACE to continue.

>s
The street goes west from here. You can enter the office to the east or the alley to the southeast.

>e
Upstairs Hall
The shuttered window at the end of the hall throws a gloomy rectangle of light onto the bare wooden floor. Doorways lead north and south.

There is a cord dangling in mid-air here, right about level with your face.

>e
You can't go that way.

>n
Library
Whatever else their faults may have been, the Verlacs were evidently not ones to shun the printed word. Books line the walls from floor to ceiling in this dark-paneled, green-carpeted room, interrupted only by doorways to the east and south. A rich, brown leather armchair sits in stately repose near the window, with a polished brass pipe stand nearby completing the picture of some blue-blooded country squire's literary refuge. Once again, you are struck by how easily this place could have been the perfect home.

A beautiful pair of mahogany sliding doors stand closed to the east.

Resting on the pipe stand is a sizable volume decorated with a gilded pentagram on its cover.

>s
Upstairs Hall
The shuttered window at the end of the hall throws a gloomy rectangle of light onto the bare wooden floor. Doorways lead north and south.

There is a cord dangling in mid-air here, right about level with your face.

>w
Upstairs Landing
A narrow hallway runs east, from the top of the stairs down the length of the house. To the north, directly opposite the stairs, is the master bedroom.

>test safe
(Testing.)

>[1] e

Upstairs Hall
The shuttered window at the end of the hall throws a gloomy rectangle of light onto the bare wooden floor. Doorways lead north and south.

There is a cord dangling in mid-air here, right about level with your face.

>[2] n

Library
Whatever else their faults may have been, the Verlacs were evidently not ones to shun the printed word. Books line the walls from floor to ceiling in this dark-paneled, green-carpeted room, interrupted only by doorways to the east and south. A rich, brown leather armchair sits in stately repose near the window, with a polished brass pipe stand nearby completing the picture of some blue-blooded country squire's literary refuge. Once again, you are struck by how easily this place could have been the perfect home.

A beautiful pair of mahogany sliding doors stand closed to the east.

Resting on the pipe stand is a sizable volume decorated with a gilded pentagram on its cover.

>[3] x books
Literally hundreds of books stuff the shelves, many of them thick, cracked, leather-bound tomes with ribbon place-holders and titles lettered in raised gold leaf. It would take you years to peruse them all. However, one interesting title does catch your eye. An authentic first printing of Edgar Allen Poe's Tales of Mystery and Imagination, shelved incongruously between volumes "G" and "H" of the Encyclopedia Americana.

>[4] x poe
It's a beautifully bound book in near-perfect condition, and probably extremely valuable -- if it really is authentic. Michael will go nuts when he sees this.

>[5] pull poe
The book sticks stubbornly at first, and, thinking that it must be tightly wedged in between the encyclopediae, you give it a fierce jerk. Suddenly, the book slides halfway out, then pops back in with a loud "snick".

Amazingly, a section of the bookshelf slides back, revealing a hidden safe.

[Your score has just gone up by one point.]

>[6] x books
The shelves on the western wall have slid back slightly, revealing a hidden safe.

>[7] x poe
It really is a shame; the book is a perfect replica of what would have been an extremely valuable edition. Notwithstanding the excitement of finding a secret wall safe in your own house, you're actually rather disappointed.

>[8] x safe
It's a stark cube of black, oily steel, fifteen inches to a side. Its only feature is large calibrated dial set into the front. The safe contains nothing

>[9] pull poe
The book slides halfway out, then pops back in with a loud "snick". The section of bookshelf slides seamlessly back into place.

>[10] x books
Edgar Allen Poe is right where you left him, sandwiched in between "G" and "H".

>[11] pull poe
The book slides halfway out, then pops back in with a loud "snick". The section of bookshelf slides away, revealing the safe once again.

>[12] turn dial
You idly give the dial a random spin.

>[13] spin dial
You idly give the dial a random spin.

>[14] spin dial to 10
The tumblers tick quietly as you turn the dial to 10.

>showme safe
safe - closed container
    dial (part of safe)
location: in Library
unlit, inedible, portable; opaque, closed, unopenable, unlocked; singular-named, improper-named
description: "It's a stark cube of black, oily steel, fifteen inches to a side. Its only feature is large calibrated dial set into the front. The safe contains nothing"
initial appearance: "A section of the shelves in the western wall has slid to one side, revealing a hidden safe."
printing: "blank"
carrying capacity: 100
printed name: "safe"
printed plural name: "containers"
indefinite article: none
list grouping key: none
stage: 0
m3: 15
m2: 28
m1: 9

>turn dial to 9
The tumblers tick quietly as you turn the dial to 9.

>turn dial to 28
The tumblers tick quietly as you turn the dial to 28.

>turn dial to 15
The tumblers tick quietly as you turn the dial to 15.

With a hollow thunk, the safe suddenly swings open.

[Your score has just gone up by two points.]

>x safe
It's a stark cube of black, oily steel, fifteen inches to a side. Its only feature is large calibrated dial set into the front. The safe contains nothing

* * *

>s
(first getting off the bed)

Upstairs Landing
A narrow hallway runs east, from the top of the stairs down the length of the house. To the north, directly opposite the stairs, is the master bedroom.

>d
Foyer
Although it appears spacious from the outside, the house's interior feels cramped and gloomy. The walls seem too close together; the ceiling is too high. The doorways, leading in several directions, are narrow and filled with shadows, and the stairs leading up to the second floor are steep and rickety. This is not a house that makes you feel welcome. It is a house that makes you feel tiny and timid, and afraid of dark places. It is a house that makes you feel alone.

Your luggage is still here, spread out all over the foyer.

>unlock front door
You lack a key that fits the front door.

>open front door
(first unlocking the front door)
You lack a key that fits the front door.

>i
You are carrying:
  your clothes (being worn)
  your trenchcoat (being worn)
  your wedding ring (being worn)

>read trenchcoat
You bought this coat during your honeymoon in England; it's a genuine London Fog. In addition to looking very cool, it has several deep pockets in which you can fit just about anything.

>s
(first opening the front door)
(first unlocking the front door)
You lack a key that fits the front door.

>w
Dining Room
Much of the elegance has faded from this room. The huge dining table running the length of it is covered with a thick gray film of dust, and the china cupboard standing against the far wall is draped in shadow. Doorways to the north and east offer little relief from the gloom. For what must be the hundredth time, you wish you could open the windows in this place.

It's a free-standing cabinet about as tall as you are, crafted of cherrywood. The double paneled doors are closed.

>open cupboard
The cupboard is empty; the china must have been auctioned off, in the confusion before Michael was contacted, perhaps. Down at the bottom of the cupboard is a velvet lining, where the silverware would usually be kept.

You open the cupboard, revealing nothing.

>x velvet
The lining is soft, dusky burgundy. One corner in back is pulled up a bit and slightly torn.

>pull it
You pull the lining back a bit further and discover a thin, palm-sized journal tucked underneath it. Intrigued, you pull the little book free.

[Your score has just gone up by two points.]

>x journal
It's a slim little book, no bigger than your hand, bound in imitation leather. The mice really have been at it; most of the pages have been chewed away.

>read it
It's a slim little book, no bigger than your hand, bound in imitation leather. The mice really have been at it; most of the pages have been chewed away.

* * *

>s
The street goes west from here. You can enter the office to the east or the alley to the southeast.

>w
Narrow Street
As the lane winds along from east to west, it narrows until the steep, jagged rooftops on either side of the street practically touch each other. To the south, a side street leads across Whateley Bridge toward the center of town, and a twisting lane leads up a hill to the northwest. A short flight of steps to the north leads down to the local watering hole.

>s
Whateley Bridge
A hoary monument of crumbling, moss-eaten flagstones, Whateley Bridge is possibly older than any other structure in the entire city. Ponderously it spans the dark, torpid waters of the Miskaton River, connecting the north and south halves of the city and occasionally raining bits of gravel and mortar from its underside into the water. It looks just wide enough for two cars to pass each other between the flanking stone parapets, but you wouldn't volunteer to try it.

>s
Town Square
A wide expanse of uneven pavestones lies open to the sky, bordered on all sides by the leaning, steep-roofed architecture that looms over everything in this city. The municipal courthouse stands at the south end of the square, next to the mouth of a dark, narrow alley to the southwest. Avenues to the west and east lead back into the cramped and ingrown streets, while to the north lies Whateley Bridge.

In the center of the square, rising from a circular lawn of unhealthy-looking grass and weeds, stands a strange, stone obelisk. It seems to be a monument of some sort, although you can see no plaque or marker anywhere near it.

>e
Riverwalk
A low, irregular brick wall to the north divides this street from the steep, mud-slick banks of the sinuous Miskaton, while a rusty iron gate provides access to a precarious flight of stone steps leading down the bank to the water's edge. The street bends south here, turning into a misty avenue between the trees. The town square lies west, a vacant lot lies east.

>e
The street leads to the west and to the south. A vacant lot lies east and a rusty gate lies to the north.

* * *

The oldest and strongest emotion of mankind
is fear, and the oldest and strongest kind of
fear is fear of the unknown.

-- H.P. Lovecraft
                                                                                                                                                                                                                                                  I N F O R M H E A D

Please press SPACE to continue.

>scenes
Scene 'Entire Game' playing (for 0 mins now)
Scene 'Day 1' playing (for 0 mins now)
Scene 'Michael Reads' playing (for 0 mins now)
(Scene monitoring now switched on. Type "scenes off" to switch it off again.)

* * *

The oldest and strongest emotion of mankind
is fear, and the oldest and strongest kind of
fear is fear of the unknown.

-- H.P. Lovecraft
                                                                                                                                                                                                                                                  I N F O R M H E A D

Please press SPACE to continue.

>se
Alley
This narrow aperture between two buildings is nearly blocked with piles of rotting cardboard boxes and overstuffed garbage cans. Ugly, half-crumbling brick walls to either side totter oppressively over you. The alley ends here at a tall, wooden fence.

High up on the wall of the northern building there is a narrow, transom-style window.

>e
You can only exit the alley to the northwest; the fence appears too tall to climb over.

>n
You can't go that way.

>s
You can't go that way.

* * *

>e
You can only exit the alley to the northwest; the fence appears too tall to climb over.

>open fence
That's not a thing you can open.

>close fence
That's not a thing you can close.

>x fence
One of the boards seems to be loose down at the bottom; you could probably just squeeze through.

>e
You can't go that way.

>map
That's not a verb I recognise.

>showme fence
fence - open door
location: in the Alley
unlit, inedible, fixed in place; open, openable, unlocked; singular-named, improper-named
description: "One of the boards seems to be loose down at the bottom; you could probably just squeeze through."
initial appearance: none
leading-through destination: <routine 222574>
printed name: "fence"
printed plural name: "doors"
indefinite article: none
list grouping key: none

>go through fence
You can't go that way.

>enter fence
You can't go that way.

>e
You can't go that way.

>w
You can't go that way.

>se
You can only exit the alley to the northwest; the fence appears too tall to climb over.

>sw
You can only exit the alley to the northwest; the fence appears too tall to climb over.

>move cans to window
Grunting and holding your breath, you manhandle one of the filthy cans under the window.

>e
You can't go that way.

>showme fence
fence - open door
location: in the Alley
unlit, inedible, fixed in place; open, openable, unlocked; singular-named, improper-named
description: "One of the boards seems to be loose down at the bottom; you could probably just squeeze through."
initial appearance: none
leading-through destination: <routine 222574>
printed name: "fence"
printed plural name: "doors"
indefinite article: none
list grouping key: none

* * *

>e
You can only exit the alley to the northwest; the fence appears too tall to climb over.

>s
You can only exit the alley to the northwest; the fence appears too tall to climb over.

>x fence
One of the boards seems to be loose down at the bottom; you could probably just squeeze through.

* * *

>e
Narrow Beach
This narrow strip of beach is tucked away between two outcroppings in the predominantly rocky shoreline, accessible only from a steep, muddy slope to the west. The sand is filthy and strewn with rocks, seaweed, litter and othreer bits of storm-tossed detritus.

Near the bottom of the slope, a sewage outflow pipe juts out over the beach, about three feet above the ground. A thin stream of acrid-smelling sewer water trickles out over the lip of the pipe, forming a puddle in the sand.

>w
You can't go that way.

* * *

>e
You can only exit the alley to the northwest; the fence appears too tall to climb over.

>w
You can't go that way.

>x window
It's about eighteen inches wide and a foot tall, with hinges along the top that allow it to swing out. It's currently closed.

>open window
You open the window.

>x window
It's about eighteen inches wide and a foot tall, with hinges along the top that allow it to swing out. It's currently closed.

* * *

>e
You can only exit the alley to the northwest; the fence appears too tall to climb over.

>x fence
One of the boards seems to be loose down at the bottom; you could probably just squeeze through.

* * *

>w
Alley
This narrow aperture between two buildings is nearly blocked with piles of rotting cardboard boxes and overstuffed garbage cans. Ugly, half-crumbling brick walls to either side totter oppressively over you. The alley ends here at a tall, wooden fence.

>s
You can only exit the alley to the northwest or crawl through the loose board to the east.

* * *

>se
Alley
This narrow aperture between two buildings is nearly blocked with piles of rotting cardboard boxes and overstuffed garbage cans. Ugly, half-crumbling brick walls to either side totter oppressively over you. The alley ends here at a tall, wooden fence.

High up on the wall of the northern building there is a narrow, transom-style window.

>l
Alley
This narrow aperture between two buildings is nearly blocked with piles of rotting cardboard boxes and overstuffed garbage cans. Ugly, half-crumbling brick walls to either side totter oppressively over you. The alley ends here at a tall, wooden fence.

High up on the wall of the northern building there is a narrow, transom-style window.

>s
You can only exit the alley to the northwest; the fence appears too tall to climb over.

>e
You can't go that way.

>e
You can't go that way.

>x fence
One of the boards seems to be loose down at the bottom; you could probably just squeeze through.

>l
Alley
This narrow aperture between two buildings is nearly blocked with piles of rotting cardboard boxes and overstuffed garbage cans. Ugly, half-crumbling brick walls to either side totter oppressively over you. The alley ends here at a tall, wooden fence.

High up on the wall of the northern building there is a narrow, transom-style window.

>e
You can't go that way.

>showme
Alley - room
    yourself - person
    fence - open door
    cans - platform
    window - closed door

>enter fence
You can't go that way.

* * *

>se
Alley
This narrow aperture between two buildings is nearly blocked with piles of rotting cardboard boxes and overstuffed garbage cans. Ugly, half-crumbling brick walls to either side totter oppressively over you. The alley ends here at a tall, wooden fence.

High up on the wall of the northern building there is a narrow, transom-style window.

>move cans
Nothing obvious happens.

* * *

>se
Alley
This narrow aperture between two buildings is nearly blocked with piles of rotting cardboard boxes and overstuffed garbage cans. Ugly, half-crumbling brick walls to either side totter oppressively over you. The alley ends here at a tall, wooden fence.

High up on the wall of the northern building there is a narrow, transom-style window.

>move cans to window
Grunting and holding your breath, you manhandle one of the filthy cans under the window.

>stand on cans
You clamber onto the wobbling garbage can, precariously balanced. You can just reach the lower edge of the window from here.

>open window
(the transom window)
You open the transom window.

>w
File Room
Peering through the murk, you can make out the blocky outlines of filing cabinets lining the walls and a doorway to the west. A window high up on the south wall lets in a very faint illumination.

>w
Rest Estate Office
Pallid gray light trickles in through the drawn blinds. The office is deserted, papers still scattered across the top of the desk. The front door lies west, and the file room lies east.

Sitting on the corner of the paper-strewn desk are a telephone and an answering machine.

>x door
You can't see any such thing.

* * *

>se
Alley
This narrow aperture between two buildings is nearly blocked with piles of rotting cardboard boxes and overstuffed garbage cans. Ugly, half-crumbling brick walls to either side totter oppressively over you. The alley ends here at a tall, wooden fence.

High up on the wall of the northern building there is a narrow, transom-style window.

>n
The window is too high

>push cans under window
You can't see any such thing.

>l
Alley
This narrow aperture between two buildings is nearly blocked with piles of rotting cardboard boxes and overstuffed garbage cans. Ugly, half-crumbling brick walls to either side totter oppressively over you. The alley ends here at a tall, wooden fence.

High up on the wall of the northern building there is a narrow, transom-style window.

>x cans
The metal garbage cans are stuffed to overflowing with slowly decomposing refuse.

>push cans to window
Grunting and holding your breath, you manhandle one of the filthy cans under the window.

>stand on cans
You clamber onto the wobbling garbage can, precariously balanced. You can just reach the lower edge of the window from here.

>open window
(the window)
You open the window.

>enter window
(the window)
(first getting off the cans)

File Room
Peering through the murk, you can make out the blocky outlines of filing cabinets lining the walls and a doorway to the west. A window high up on the south wall lets in a very faint illumination.

>w
Office
Pallid gray light trickles in through the drawn blinds. The office is deserted, papers still scattered across the top of the desk. The front door lies west, and the file room lies east.

Sitting on the corner of the paper-strewn desk are a telephone and an answering machine.

Someone seems to have left a cup of coffee sitting out, half-finished and cold.

>open latch
It isn't something you can open.

>turn latch
You unlock the office door.

>w
(first opening the office door)

Outside the Real Estate Office
A grim little cul-de-sac, tucked away in a corner of the claustrophobic tangle of narrow, twisting avenues that largely constitute the older portion of Anchorhead. Like most of the streets in this city, it is ancient, shadowy, and leads essentially nowhere. The lane ends here at the real estate agent's office, which lies to the east, and winds its way back toward the center of town to the west. A narrow, garbage-choked alley opens to the southeast.

You can see an office door here.

>l
Outside the Real Estate Office
A grim little cul-de-sac, tucked away in a corner of the claustrophobic tangle of narrow, twisting avenues that largely constitute the older portion of Anchorhead. Like most of the streets in this city, it is ancient, shadowy, and leads essentially nowhere. The lane ends here at the real estate agent's office, which lies to the east, and winds its way back toward the center of town to the west. A narrow, garbage-choked alley opens to the southeast.

You can see an office door here.

* * *

>se
Alley
This narrow aperture between two buildings is nearly blocked with piles of rotting cardboard boxes and overstuffed garbage cans. Ugly, half-crumbling brick walls to either side totter oppressively over you. The alley ends here at a tall, wooden fence.

High up on the wall of the northern building there is a narrow, transom-style window.

>open window
You open the window.

>close window
You close the window.

>open window
You open the window.

>push cans to window
You can't see any such thing.

>x cans
The metal garbage cans are stuffed to overflowing with slowly decomposing refuse.

>push cans to cans
You can't see any such thing.

* * *

>se
Alley
This narrow aperture between two buildings is nearly blocked with piles of rotting cardboard boxes and overstuffed garbage cans. Ugly, half-crumbling brick walls to either side totter oppressively over you. The alley ends here at a tall, wooden fence.

High up on the wall of the northern building there is a narrow, transom-style window.

>push cans
You push the garbage cans around aimlessly.

>push cans n
The cans cannot be pushed from place to place.

>push cans to window
Foo

* * *

>push cans
You push the garbage cans around aimlessly.

>push cans to window
Grunting and holding your breath, you manhandle one of the filthy cans under the window.

>l
Alley
This narrow aperture between two buildings is nearly blocked with piles of rotting cardboard boxes and overstuffed garbage cans. Ugly, half-crumbling brick walls to either side totter oppressively over you. The alley ends here at a tall, wooden fence.

High up on the wall of the northern building there is a narrow, transom-style window. One of the garbage cans has been pushed up against the wall directly underneath it.

>push cans to window
Little else would be accomplished at this point.

* * *

>push cans
You push the garbage cans around aimlessly.

>push cans window
Grunting and holding your breath, you manhandle one of the filthy cans under the window.

>push cans to window
Little else would be accomplished at this point.

* * *

>se
Alley
This narrow aperture between two buildings is nearly blocked with piles of rotting cardboard boxes and overstuffed garbage cans. Ugly, half-crumbling brick walls to either side totter oppressively over you. The alley ends here at a tall, wooden fence.

High up on the wall of the northern building there is a narrow, transom-style window.

>push cans to window
You can't see any such thing.

>showme
Alley - room
    yourself - person
    fence
    cans - platform
    window

>actions
Actions listing on.

>push
(the window)
[pushing the window]
It is fixed in place.
[pushing the window - failed the can't push what's fixed in place rule]

>push cans to window
You can't see any such thing.

>push cans
[pushing the cans]
Grunting and holding your breath, you manhandle one of the filthy cans under the window.
[pushing the cans - failed]

>push cans to
What do you want to push the cans to?

>push cans to window
You can't see any such thing.

>rules
Rules tracing now switched on. Type "rules off" to switch it off again, or "rules all" to include even rules which do not apply.

[Rule "parse command rule" applies.]

>push cans to window
You can't see any such thing.

* * *

>se
Alley
This narrow aperture between two buildings is nearly blocked with piles of rotting cardboard boxes and overstuffed garbage cans. Ugly, half-crumbling brick walls to either side totter oppressively over you. The alley ends here at a tall, wooden fence.

High up on the wall of the northern building there is a narrow, transom-style window.

>push cans window
The cans cannot be pushed from place to place.

* * *

>se
Alley
This narrow aperture between two buildings is nearly blocked with piles of rotting cardboard boxes and overstuffed garbage cans. Ugly, half-crumbling brick walls to either side totter oppressively over you. The alley ends here at a tall, wooden fence.

High up on the wall of the northern building there is a narrow, transom-style window.

>s
You can only exit the alley to the northwest; the fence appears too tall to climb over.

* * *

>e
You can't go that way.

>open fence
You open the fence.

>close fence
You close the fence.

* * *

>se
Alley
This narrow aperture between two buildings is nearly blocked with piles of rotting cardboard boxes and overstuffed garbage cans. Ugly, half-crumbling brick walls to either side totter oppressively over you. The alley ends here at a tall, wooden fence.

High up on the wall of the northern building there is a narrow, transom-style window.

>stand on cans
You clamber onto the wobbling garbage can, precariously balanced.

>d
You can only exit the alley to the northwest; the fence appears too tall to climb over.

>get off cans
You get off the cans.

Alley
This narrow aperture between two buildings is nearly blocked with piles of rotting cardboard boxes and overstuffed garbage cans. Ugly, half-crumbling brick walls to either side totter oppressively over you. The alley ends here at a tall, wooden fence.

High up on the wall of the northern building there is a narrow, transom-style window.

* * *

>stand on cans
You clamber onto the wobbling garbage can, precariously balanced.

>descend
That's not a verb I recognise.

>get off cans
Carefully, you descend.

* * *

>se
Alley
This narrow aperture between two buildings is nearly blocked with piles of rotting cardboard boxes and overstuffed garbage cans. Ugly, half-crumbling brick walls to either side totter oppressively over you. The alley ends here at a tall, wooden fence.

High up on the wall of the northern building there is a narrow, transom-style window.

>u
You can only exit the alley to the northwest; the fence appears too tall to climb over.

>push cans
You push the garbage cans around aimlessly.

* * *

>push cans to window
Grunting and holding your breath, you manhandle one of the filthy cans under the window.

>push cans to window
Little else would be accomplished at this point.

>push cans
Little else would be accomplished at this point.

>k
That's not a verb I recognise.

>l
Alley
This narrow aperture between two buildings is nearly blocked with piles of rotting cardboard boxes and overstuffed garbage cans. Ugly, half-crumbling brick walls to either side totter oppressively over you. The alley ends here at a tall, wooden fence.

High up on the wall of the northern building there is a narrow, transom-style window. One of the garbage cans has been pushed up against the wall directly underneath it.

>stand on cans
You get onto the cans.

>d
You can only exit the alley to the northwest; the fence appears too tall to climb over.

>stand
You get off the cans.

Alley
This narrow aperture between two buildings is nearly blocked with piles of rotting cardboard boxes and overstuffed garbage cans. Ugly, half-crumbling brick walls to either side totter oppressively over you. The alley ends here at a tall, wooden fence.

High up on the wall of the northern building there is a narrow, transom-style window. One of the garbage cans has been pushed up against the wall directly underneath it.

>open window
You must name something more substantial.

* * *

>se
Alley
This narrow aperture between two buildings is nearly blocked with piles of rotting cardboard boxes and overstuffed garbage cans. Ugly, half-crumbling brick walls to either side totter oppressively over you. The alley ends here at a tall, wooden fence.

High up on the wall of the northern building there is a narrow, transom-style window.

>x cans
The metal garbage cans are stuffed to overflowing with slowly decomposing refuse.

>move cans
It is fixed in place.

* * *

>x cans
The metal garbage cans are stuffed to overflowing with slowly decomposing refuse.

>move cans to window
Grunting and holding your breath, you manhandle one of the filthy cans under the window.

>x cans
The metal garbage cans are stuffed to overflowing with slowly decomposing refuse.

>stand on cans
You clamber onto the wobbling garbage can, precariously balanced.
You can just reach the lower edge of the window from here.

>get off cans
Carefully, you descend.

>open window
(the transom window)
The window is too high.

>stand on cans
You clamber onto the wobbling garbage can, precariously balanced.
You can just reach the lower edge of the window from here.

>open window
(the transom window)
You open the transom window.

>close window
(the transom window)
You close the transom window.

>get off video
You can't see any such thing.

>stand on cans
You clamber onto the wobbling garbage can, precariously balanced.
You can just reach the lower edge of the window from here.

>w
You can only exit the alley to the northwest; the fence appears too tall to climb over.

>w
You can only exit the alley to the northwest; the fence appears too tall to climb over.

* * *

>x cans
The metal garbage cans are stuffed to overflowing with slowly decomposing refuse.

>push cans
You push the garbage cans around aimlessly.

* * *

>push cans n
The cans cannot be pushed from place to place.

>push cans window
Grunting and holding your breath, you manhandle one of the filthy cans under the window.

>l
Alley
This narrow aperture between two buildings is nearly blocked with piles of rotting cardboard boxes and overstuffed garbage cans. Ugly, half-crumbling brick walls to either side totter oppressively over you. The alley ends here at a tall, wooden fence.

High up on the wall of the northern building there is a narrow, transom-style window. One of the garbage cans has been pushed up against the wall directly underneath it.

>push cans window
Little else would be accomplished at this point.

>push cans
You push the garbage cans around aimlessly.

>push cans window
Little else would be accomplished at this point.

* * *

>x cans
The metal garbage cans are stuffed to overflowing with slowly decomposing refuse.

>x window
(the window)
It's about eighteen inches wide and a foot tall, with hinges along the top that allow it to swing out. It's currently closed.

>open window
(the window)
You open the window.

>close window
(the window)
You close the window.

* * *

>se
Alley
This narrow aperture between two buildings is nearly blocked with piles of rotting cardboard boxes and overstuffed garbage cans. Ugly, half-crumbling brick walls to either side totter oppressively over you. The alley ends here at a tall, wooden fence.

High up on the wall of the northern building there is a narrow, transom-style window.

>x window
(the transom window)
It's about eighteen inches wide and a foot tall, with hinges along the top that allow it to swing out. It's currently closed.

>x transom
It's about eighteen inches wide and a foot tall, with hinges along the top that allow it to swing out. It's currently closed.

* * *

The oldest and strongest emotion of mankind
is fear, and the oldest and strongest kind of
fear is fear of the unknown.

-- H.P. Lovecraft
                                                                                                                                                                                                                                                  I N F O R M H E A D

Please press SPACE to continue.

>showme hatch
hatch - locked door
location: in Bare Foundations
unlit, inedible, fixed in place, scenery; closed, openable, lockable, locked; singular-named, improper-named
description: none
initial appearance: "Set into the base of the mill wall, nearly covered by the thickets, is a metal hatch."
printed name: "hatch"
printed plural name: "doors"
indefinite article: none
list grouping key: none

>w. w. n. w. sw.
Narrow Street
As the lane winds along from east to west, it narrows until the steep, jagged rooftops on either side of the street practically touch each other. To the south, a side street leads across Whateley Bridge toward the center of town, and a twisting lane leads up a hill to the northwest. A short flight of steps to the north leads down to the local watering hole.

Junction
To the north, a gap in the crowded press of gloomy buildings opens onto a country lane, heading out over a grassy heath. The main street continues to the east, while to the northwest, over the top of a steep rise, you can just make out the vaulted rooftops of the university.

Mill Road
The road carries you across a desolate heath of gray, windswept grass. To the south, the black, jagged outline of Anchorhead's steep roofs and sharp, leaning gables cuts across the horizon. The road forks here to the west and east, heading across the railroad tracks in one direction, out toward the seashore in the other.

As you cross the railroad tracks, the air becomes warmer, more dingy, and slightly more difficult to breathe.

Entrance to the Paper Mill
The road turns southwest here and runs squarely through the front entrance to the old paper mill. A gate of heavy iron bars blocks the only opening into this charred fortress, although an overgrown path leads around the wall to the south. To the north, a rutted lane threads its way past a row of dilapidated shacks.

(first opening the iron gate)
It seems to be locked.

>s
The path curves southwest, leading you into an overgrown area behind the mill.

Bare Foundations
The foundations of an older structure lie crumbling in a sunken square of ground, hidden away behind the imposing shadow of the mill wall. Weeds push up through cracked and buckling slabs of concrete; twisted rebar and rusting pipes poke up like the legs of dead insects. The ruins are surrounded on all sides by dense thickets, although narrow, overgrown trails lead northeast and southeast through the underbrush.

>x hatch
You see nothing special about the hatch.

>search thicket
Carefully pushing the prickly branches aside, you find a rusty metal hatch set into the base of the wall.

>x hatch
You see nothing special about the hatch.

>l
Bare Foundations
The foundations of an older structure lie crumbling in a sunken square of ground, hidden away behind the imposing shadow of the mill wall. Weeds push up through cracked and buckling slabs of concrete; twisted rebar and rusting pipes poke up like the legs of dead insects. The ruins are surrounded on all sides by dense thickets, although narrow, overgrown trails lead northeast and southeast through the underbrush.

Set into the base of the mill wall, nearly covered by the thickets, is a metal hatch.

>open hatch
It seems to be locked.

>n
The thickets are too dense in that direction.

* * *

The oldest and strongest emotion of mankind
is fear, and the oldest and strongest kind of
fear is fear of the unknown.

-- H.P. Lovecraft
                                                                                                                                                                                                                                                  I N F O R M H E A D

Please press SPACE to continue.

>showme safe
safe - closed container
    dial (part of safe)
location: out of play
unlit, inedible, portable; opaque, closed, unopenable, unlocked; singular-named, improper-named
description: "It's a stark cube of black, oily steel, fifteen inches to a side. Its only feature is large calibrated dial set into the front."
initial appearance: "A section of the shelves in the western wall has slid to one side, revealing a hidden safe."
printing: "blank"
carrying capacity: 100
printed name: "safe"
printed plural name: "containers"
indefinite article: none
list grouping key: none
m1: 51
m2: 2
m3: 38

* * *

The oldest and strongest emotion of mankind
is fear, and the oldest and strongest kind of
fear is fear of the unknown.

-- H.P. Lovecraft
                                                                                                                                                                                                                                                  I N F O R M H E A D

Please press SPACE to continue.

>sleep
Prevented?
Entire Game -> happening .
Day 1 -> happening .
Michael Reads -> happening .
Michael Follows ->  .
Michael Sleeps ->  tired.
Day 2 ->  .
Michael Showers ->  .
Michael Writes ->  .
Close of Day ->  tired.
Day 3 ->  .
Day 4 ->  .
Day 5 ->  .
You're not tired.

* * *

>scenes
Scene 'Entire Game' playing (for 40 mins now)
Scene 'Day 1' playing (for 40 mins now)
Scene 'Michael Reads' ended
Scene 'Michael Follows' ended
Scene 'Michael Sleeps' playing (for 13 mins now)
(Scene monitoring now switched on. Type "scenes off" to switch it off again.)

>showme Michael Sleeps
I only understood you as far as wanting to showme Michael.

* * *

The oldest and strongest emotion of mankind
is fear, and the oldest and strongest kind of
fear is fear of the unknown.

-- H.P. Lovecraft
                                                                                                                                                                                                                                                  I N F O R M H E A D

Please press SPACE to continue.

>stand on ca
You can't see any such thing.

>se
Alley
This narrow aperture between two buildings is nearly blocked with piles of rotting cardboard boxes and overstuffed garbage cans. Ugly, half-crumbling brick walls to either side totter oppressively over you. The alley ends here at a tall, wooden fence.

High up on the wall of the northern building there is a narrow, transom-style window.

>stand on cans
Foo

* * *

The oldest and strongest emotion of mankind
is fear, and the oldest and strongest kind of
fear is fear of the unknown.

-- H.P. Lovecraft
                                                                                                                                                                                                                                                  I N F O R M H E A D

Please press SPACE to continue.

>stand. take clothes. s. e. u.
But you aren't in anything at the moment.

You already have those.

The street goes west from here. You can enter the office to the east or the alley to the southeast.

(first opening the office door)
(first unlocking the office door)
You can't reach into Office.

The street goes west from here. You can enter the office to the east or the alley to the southeast.

>go2
You wake up. Steam billows gently by, and you can hear the sound of running water coming from the bathroom.

>stand. take clothes. s. e. u.
You get off the bed.

Master Bedroom
The master bedroom is a picture-postcard of rustic New England charm. Faded sketches of rural landscapes adorn the walls; a beautifully carved dressing mirror stands in one corner; an old-fashioned accordion radiator gurgles quietly beneath the window. The most striking feature, an enormous, antique, four-poster bed, must be the largest piece of furniture in the house.

On the four-poster bed you can see Michael's pants.

Someone has left a flask underneath one of the tables.

An old, discarded tin of fish oil sits at the end of the pier.

You can also see your trenchcoat, your clothes, your keyring (empty), your umbrella, a house key and a cellar key here.

You put on the clothes.

Upstairs Landing
A narrow hallway runs east, from the top of the stairs down the length of the house. To the north, directly opposite the stairs, is the master bedroom.

Upstairs Hall
The shuttered window at the end of the hall throws a gloomy rectangle of light onto the bare wooden floor. Doorways lead north and south.

There is a cord dangling in mid-air here, right about level with your face

(first opening the attic ladder)
It isn't something you can open.

* * *

>i
You are carrying:
  a cellar key
  a house key
  your umbrella
  your keyring
  Michael's faculty card
  your clothes (being worn)
  your trenchcoat (being worn)
  your wedding ring (being worn)

>l
Master Bedroom
The master bedroom is a picture-postcard of rustic New England charm. Faded sketches of rural landscapes adorn the walls; a beautifully carved dressing mirror stands in one corner; an old-fashioned accordion radiator gurgles quietly beneath the window. The most striking feature, an enormous, antique, four-poster bed, must be the largest piece of furniture in the house.

You can see a keyring (empty), a house key and a cellar key here.

>s
Upstairs Landing
A narrow hallway runs east, from the top of the stairs down the length of the house. To the north, directly opposite the stairs, is the master bedroom.

>e
Upstairs Hall
The shuttered window at the end of the hall throws a gloomy rectangle of light onto the bare wooden floor. Doorways lead north and south.

>e
You can't go that way.

>w
Upstairs Landing
A narrow hallway runs east, from the top of the stairs down the length of the house. To the north, directly opposite the stairs, is the master bedroom.

>restart
Are you sure you want to restart?

>y
Informhead
An Interactive Fiction by Ed Peters
Release 1 / Serial number 230522 / Inform 7 v10.1.2 / D

Outside the Real Estate Office
A grim little cul-de-sac, tucked away in a corner of the claustrophobic tangle of narrow, twisting avenues that largely constitute the older portion of Anchorhead. Like most of the streets in this city, it is ancient, shadowy, and leads essentially nowhere. The lane ends here at the real estate agent's office, which lies to the east, and winds its way back toward the center of town to the west. A narrow, garbage-choked alley opens to the southeast.

Resting on the pipe stand is a sizable volume decorated with a gilded pentagram on its cover.

>test msleeps
(Testing.)

>[1] u
The street goes west from here. You can enter the office to the east or the alley to the southeast.

>[2] n
The street goes west from here. You can enter the office to the east or the alley to the southeast.

>[3] sleep
This isn't the best place for it.
You really should get in bed first.

>[4] s
The street goes west from here. You can enter the office to the east or the alley to the southeast.

>[5] d
The street goes west from here. You can enter the office to the east or the alley to the southeast.

>[6] close door
That's already closed.

>[7] lock it
The office door is already locked.

>[8] u
The street goes west from here. You can enter the office to the east or the alley to the southeast.

>[9] n
The street goes west from here. You can enter the office to the east or the alley to the southeast.

>restart
Are you sure you want to restart?

* * *

>u
Upstairs Landing
A narrow hallway runs east, from the top of the stairs down the length of the house. To the north, directly opposite the stairs, is the master bedroom.

>e
Upstairs Hall
The shuttered window at the end of the hall throws a gloomy rectangle of light onto the bare wooden floor. Doorways lead north and south.

>w
Upstairs Landing
A narrow hallway runs east, from the top of the stairs down the length of the house. To the north, directly opposite the stairs, is the master bedroom.

>e
Upstairs Hall
The shuttered window at the end of the hall throws a gloomy rectangle of light onto the bare wooden floor. Doorways lead north and south.

>n
Library
Whatever else their faults may have been, the Verlacs were evidently not ones to shun the printed word. Books line the walls from floor to ceiling in this dark-paneled, green-carpeted room, interrupted only by doorways to the east and south. A rich, brown leather armchair sits in stately repose near the window, with a polished brass pipe stand nearby completing the picture of some blue-blooded country squire's literary refuge. Once again, you are struck by how easily this place could have been the perfect home.

A beautiful pair of mahogany sliding doors stand closed to the east.

>s
Upstairs Hall
The shuttered window at the end of the hall throws a gloomy rectangle of light onto the bare wooden floor. Doorways lead north and south.

>w
Upstairs Landing
A narrow hallway runs east, from the top of the stairs down the length of the house. To the north, directly opposite the stairs, is the master bedroom.

* * *

>i
You are carrying:
  a cellar key
  a house key
  your umbrella
  your keyring
  Michael's faculty card
  your clothes (being worn)
  your trenchcoat (being worn)
  your wedding ring (being worn)

>restart
Are you sure you want to restart?

>y
Informhead
An Interactive Fiction by Ed Peters
Release 1 / Serial number 230524 / Inform 7 v10.1.2 / D

Outside the Real Estate Office
A grim little cul-de-sac, tucked away in a corner of the claustrophobic tangle of narrow, twisting avenues that largely constitute the older portion of Anchorhead. Like most of the streets in this city, it is ancient, shadowy, and leads essentially nowhere. The lane ends here at the real estate agent's office, which lies to the east, and winds its way back toward the center of town to the west. A narrow, garbage-choked alley opens to the southeast.

>test cabinet
(Testing.)

>[1] x cabinet
You can't see any such thing.

>[2] consult cabinet about foo
You can't see any such thing.

>[3] consult cabinet about verlac
You can't see any such thing.

>[4] g
You can't see any such thing.

>test window
(Testing.)

>[1] se

Alley
This narrow aperture between two buildings is nearly blocked with piles of rotting cardboard boxes and overstuffed garbage cans. Ugly, half-crumbling brick walls to either side totter oppressively over you. The alley ends here at a tall, wooden fence.

High up on the wall of the northern building there is a narrow, transom-style window. 

>[2] open window
(the window)
The window is too high.

>[3] look through window
(the window)
The window is too high.

>[4] move cans
You push the garbage cans around aimlessly.

>[5] stand on cans
You clamber onto the wobbling garbage can, precariously balanced.

>[6] look through window
(the window)
The window is too high.

>[7] get off cans
You get off the cans.

Alley
This narrow aperture between two buildings is nearly blocked with piles of rotting cardboard boxes and overstuffed garbage cans. Ugly, half-crumbling brick walls to either side totter oppressively over you. The alley ends here at a tall, wooden fence.

High up on the wall of the northern building there is a narrow, transom-style window. 

>[8] push cans to window
Grunting and holding your breath, you manhandle one of the filthy cans under the window.

>[9] stand on cans
You clamber onto the wobbling garbage can, precariously balanced. You can just reach the lower edge of the window from here.

>[10] look through window
(the window)
Peering in through the foggy glass, you can see what looks like a file room.

>[11] open window
(the window)
You open the window.

The rain slackens off momentarily to a weak drizzle, then returns afresh in a brief, freezing downpour.

>[12] enter window
(the window)
(first getting off the cans)

File Room
Peering through the murk, you can make out the blocky outlines of filing cabinets lining the walls and a doorway to the west. A window high up on the south wall lets in a very faint illumination.

>[13] w

Office
Pallid gray light trickles in through the drawn blinds. The office is deserted, papers still scattered across the top of the desk. The front door lies west, and the file room lies east.

Sitting on the corner of the paper-strewn desk are a telephone and an answering machine.

Someone seems to have left a cup of coffee sitting out, half-finished and cold.

>[14] x latch
It's a little knob that can be turned to lock or unlock the door. It's currently locked.

>[15] turn latch
You unlock the office door.

>[16] w
(first opening the office door)

Outside the Real Estate Office
A grim little cul-de-sac, tucked away in a corner of the claustrophobic tangle of narrow, twisting avenues that largely constitute the older portion of Anchorhead. Like most of the streets in this city, it is ancient, shadowy, and leads essentially nowhere. The lane ends here at the real estate agent's office, which lies to the east, and winds its way back toward the center of town to the west. A narrow, garbage-choked alley opens to the southeast.

The office door is open.

>e
Office
Pallid gray light trickles in through the drawn blinds. The office is deserted, papers still scattered across the top of the desk. The front door lies west, and the file room lies east.

Sitting on the corner of the paper-strewn desk are a telephone and an answering machine.

The office door is open.

Someone seems to have left a cup of coffee sitting out, half-finished and cold.

>e
File Room
Peering through the murk, you can make out the blocky outlines of filing cabinets lining the walls and a doorway to the west. A window high up on the south wall lets in a very faint illumination.

>test cabinet
(Testing.)

>[1] x cabinet
There must be hundreds of files here, too many to browse through. You'll have to look up something specific if you want to find anything.

>[2] consult cabinet about foo
You don't find anything filed under that foo.

>[3] consult cabinet about verlac
Strange; the file on the Verlac property has been cleaned out. Title, deed, all the papers, all of it gone. There is, however, a set of keys tucked down in the hanging folder. You quickly pocket them.

[Your score has just gone up by two points.]

>[4] g
You've already perused that file once.

>i
You are carrying:
  your clothes (being worn)
  your trenchcoat (being worn)
  your wedding ring (being worn)
  your umbrella
  your keyring
    a cellar key
    a house key

>w.w.w.w.
Office
Pallid gray light trickles in through the drawn blinds. The office is deserted, papers still scattered across the top of the desk. The front door lies west, and the file room lies east.

Sitting on the corner of the paper-strewn desk are a telephone and an answering machine.

The office door is open.

Someone seems to have left a cup of coffee sitting out, half-finished and cold.

Outside the Real Estate Office
A grim little cul-de-sac, tucked away in a corner of the claustrophobic tangle of narrow, twisting avenues that largely constitute the older portion of Anchorhead. Like most of the streets in this city, it is ancient, shadowy, and leads essentially nowhere. The lane ends here at the real estate agent's office, which lies to the east, and winds its way back toward the center of town to the west. A narrow, garbage-choked alley opens to the southeast.

The office door is open.

Narrow Street
As the lane winds along from east to west, it narrows until the steep, jagged rooftops on either side of the street practically touch each other. To the south, a side street leads across Whateley Bridge toward the center of town, and a twisting lane leads up a hill to the northwest. A short flight of steps to the north leads down to the local watering hole.

Junction
To the north, a gap in the crowded press of gloomy buildings opens onto a country lane, heading out over a grassy heath. The main street continues to the east, while to the northwest, over the top of a steep rise, you can just make out the vaulted rooftops of the university.

>nw.w.
University Court
Isolated and serene within its high, ivy-covered walls, Miskaton University represents this benighted town's single, if somewhat dubious, claim to cultural achievement. Founded some time in the early 1800s, the school's reputation and enrollment have diminished somewhat as Anchorhead drifts further and further into the abyss of provincial backwaterism. Still, it is generally recognized for its collection of folklore and esoteric mythology (one of the oldest and most extensive on the east coast). The Board of Deans was also kind enough to offer Michael a full professorship upon hearing of his recently discovered heritage and his plans to move into the estate. Ivory tower, perhaps, but at least they take care of their own.

There are numerous buildings surrounding this cobbled court, but the only one you are interested in is the library to the west, where Michael told you he'd be until he came back to the real estate agent's office to pick you up. Which, incidentally, he has not yet done.

Library
Shadows roost thickly in the vaulted ceiling, and small, green-shaded desk lamps cast pools of warm radiance here and there around the library's dim interior. You pause a moment to let the hushed peacefulness of this place soak in -- a welcome relief from the unsettling events of the day. An exit lies east, and a small alcove to the north houses the circulation counter.

Peering through the shadows, you spot your husband sitting at one of the reading desks, absorbed in some sort of weighty tome and clearly oblivious to the time.

>show house key to michael
(first taking the house key)
Michael looks up, startled, then realizes it's you and smiles. "Hi, hon," he says, closing the book and stretching. Then he glances at his watch. "Good grief, what happened to the time? I'm so sorry -- I just lost track." He smiles sheepishly.

"Well?" he asks. "Did you get the keys?"

Michael turns to a new page in the book and begins reading intently.

>show house key to michael
"Great!" says Michael. "You hang on to that. Just a second, I'll put this back." He takes the book up to the circulation desk and hands it to the librarian. "Okay then," he says, returning, "let's go."

Michael suddenly smacks his forehead. "Oh, crap, I forgot to tell you. The car broke down." He spreads his hands. "I don't know what happened to it; one second I'm parking outside, the next second it dies and I can't get it started again. I called a tow truck, but the nearest garage is up in Arkham. They picked it up but won't be able to look at it until next week at the earliest. Anyway, it looks like we'll have to walk back to the house." He offers you a lame smile. "You can hold the umbrella.

[Your score has just gone up by two points.]

* * *

>s
Upstairs Landing
A narrow hallway runs east, from the top of the stairs down the length of the house. To the north, directly opposite the stairs, is the master bedroom.

>d
Foyer
Although it appears spacious from the outside, the house's interior feels cramped and gloomy. The walls seem too close together; the ceiling is too high. The doorways, leading in several directions, are narrow and filled with shadows, and the stairs leading up to the second floor are steep and rickety. This is not a house that makes you feel welcome. It is a house that makes you feel tiny and timid, and afraid of dark places. It is a house that makes you feel alone.

Your luggage is still here, spread out all over the foyer.

>n
Back Hall
A short hallway, connecting rooms to the east, west and south.

* * *

>take light. turn it on. nw.
You take the flashlight. It's battery-powered, and waterproof too, by the look of it..

I only understood you as far as wanting to turn the flashlight.

>turn on flashlight
You switch the flashlight on.

>nw
Pantry
The pantry is empty save for a layer of dust on the shelves. A door to the south leads down to the cellar, or you can return to the kitchen to the southeast.

Leaning in the corner is an old broom.

>unlock door
(with the cellar key)
You unlock the cdoor.

* * *

>z
Time passes.

>z
Time passes.

I beg your pardon?

>z
Time passes.

>open mahogany doors
Michael is in the study, typing furiously at his laptop. As you walk in he looks up at you with a pained expression. "Can it wait?" he asks you. "I think I'm onto something really good here, and if I don't get it all out I'm going to lose it. If you don't mind, hon, I could really use the next hour or so to myself."

Not wanting to disturb him, you tiptoe out, shutting the doors quietly behind you.

You can hear Michael in the next room, typing away.

>open mahogany doors
Wishing to avoid another reprisal, you decide to leave Michael alone until he's finished writing.

>open mahogany doors
Wishing to avoid another reprisal, you decide to leave Michael alone until he's finished writing.

>open mahogany doors
Wishing to avoid another reprisal, you decide to leave Michael alone until he's finished writing.

You can hear Michael in the next room, typing away.

>z
Time passes.

* * *

>s. d. s. se. ne. n. n.
Upstairs Landing
A narrow hallway runs east, from the top of the stairs down the length of the house. To the north, directly opposite the stairs, is the master bedroom.

Foyer
Although it appears spacious from the outside, the house's interior feels cramped and gloomy. The walls seem too close together; the ceiling is too high. The doorways, leading in several directions, are narrow and filled with shadows, and the stairs leading up to the second floor are steep and rickety. This is not a house that makes you feel welcome. It is a house that makes you feel tiny and timid, and afraid of dark places. It is a house that makes you feel alone.

Your luggage is still here, spread out all over the foyer.

(first opening the front door)
(first unlocking the front door)
(with the house key)

Outside the House
The lane runs up from the southeast and ends at a wide clearing surrounded by gnarled and ancient trees. A wide, curving driveway runs up to the front door of your house, which lies north.

The Verlac mansion looms before you, casting an air of menace ove the clearing.

A typewritten notice has been attached to the front door.

Scenic View
The treeline falls away on the north side of this northwest-northeast bend in the road, giving way to a panoramic view of the Miskaton River Valley and the grubby little town of Anchorhead nestled within it. From here you can see the paper mill almost directly to the north; the solitary lighthouse and surrounding ocean to the northeast; and the dilapidated stone church below you to the east. Winding through it all is the oily black ribbon of the Miskaton, and almost directly in the center lies the little clearing of Town Square. You can just make out the shape of the obelisk from here.

Chilly Avenue
Perhaps it is merely the effect of some unwholesome vapour rising from the murky waters of the nearby Miskaton, but the temperature along this street seems perceptibly cooler than normal, even for a New England autumn. Two dirt roads lead south and southwest, into the dense woods at the edge of town.

Riverwalk
A low, irregular brick wall to the north divides this street from the steep, mud-slick banks of the sinuous Miskaton, while a rusty iron gate provides access to a precarious flight of stone steps leading down the bank to the water's edge. The street bends south here, turning into a misty avenue between the trees. The town square lies west, a vacant lot lies east.

The street leads to the west and to the south. A vacant lot lies east and a rusty gate lies to the north.

>w. n. n. n.
Town Square
A wide expanse of uneven pavestones lies open to the sky, bordered on all sides by the leaning, steep-roofed architecture that looms over everything in this city. The municipal courthouse stands at the south end of the square, next to the mouth of a dark, narrow alley to the southwest. Avenues to the west and east lead back into the cramped and ingrown streets, while to the north lies Whateley Bridge.

In the center of the square, rising from a circular lawn of unhealthy-looking grass and weeds, stands a strange, stone obelisk. It seems to be a monument of some sort, although you can see no plaque or marker anywhere near it.

A damp newspaper lies on the curb, fluttering slightly in the wind.

Whateley Bridge
A hoary monument of crumbling, moss-eaten flagstones, Whateley Bridge is possibly older than any other structure in the entire city. Ponderously it spans the dark, torpid waters of the Miskaton River, connecting the north and south halves of the city and occasionally raining bits of gravel and mortar from its underside into the water. It looks just wide enough for two cars to pass each other between the flanking stone parapets, but you wouldn't volunteer to try it.

Narrow Street
As the lane winds along from east to west, it narrows until the steep, jagged rooftops on either side of the street practically touch each other. To the south, a side street leads across Whateley Bridge toward the center of town, and a twisting lane leads up a hill to the northwest. A short flight of steps to the north leads down to the local watering hole.

Local Pub
A dank, drafty old drinking hole lit by flickering, oil-burning lanterns. Smoke collects in greasy pools among the rafters, and shadows crowd thick around. The bar runs the length of the room to your right, while to the south a low doorway opens onto the street.

Mill workers and fishermen occupy a few of the tables, drinking beer or puffing grimly at long-stemmed pipes. Each is wrapped in his solitude, soaking up the general miasma of dreary fatalism.

The lantern sitting on the table nearest you sputters fitfully, throwing distorted shadows across the wall.

>s
As you make your way to the door, your foot strikes something under one of the tables.

Narrow Street
As the lane winds along from east to west, it narrows until the steep, jagged rooftops on either side of the street practically touch each other. To the south, a side street leads across Whateley Bridge toward the center of town, and a twisting lane leads up a hill to the northwest. A short flight of steps to the north leads down to the local watering hole.

* * *

>read register
Nothing is written on the register.

>consult register about michael
Your husband's name is down at the bottom. The title of the book is A Historical Overview of Superstitions in the Miskaton Valley Region by J. Arnsworth Frazer, pub. 1906. Quite a mouthful.

>ring bell
Ding!

A moment later, the gaunt and fishy-eyed librarian emerges silently from the shadows behind the counter.

>ask librarian about frazer
The librarian says nothing. Slowly, very slowly, she looks you up and down, and then, just as slowly, she turns to look at the sign posted over the counter. Finally, agonizingly slowly, she turns back to you, and stares at you with a vague, unblinking air of disapproval.

>show card to librarian
The librarian looks the card over, nods slowly, and hands it back to you without a word.

>ask librarian about frazer
Wordlessly the librarian retreats back into the shadows, only to reappear the next moment carrying the thick, dusty tome you saw your husband with earlier. Dutifully, you sign the register, and the librarian hands you the book before disappearing again.

[Your score has just gone up by two points.]

>i
You are carrying:
  A Historical Overview of Superstitions by J. Arnsworth Frazer
  a cellar key
  a house key
  your umbrella
  your keyring
  Michael's faculty card
  your clothes (being worn)
  your trenchcoat (being worn)
  your wedding ring (being worn)

>read frazer
As you open the book, a slip of paper falls from its pages and flutters to the ground.

* * *

>l
Circulation Desk
A high counter divides the public portion of the library from the reserved stacks -- all the more esoteric and mysterious volumes from the university's collection. If anything, the area behind the counter is even more shadowy than the side you're on. The main reading area lies south.

Hanging on the wall next to the counter is a small, printed sign. Beneath the sign sits a heavy, dog-eared register, and sitting next to the register is a bell.

You can see a slip of paper here.

>x paper
Someone was apparently using it as a bookmark. There's some writing on one side.

>ead it
That's not a verb I recognise.

>read it
It says:  born-died same date? have to chk. records  The handwriting is unmistakably Michael's.

* * *

The oldest and strongest emotion of mankind
is fear, and the oldest and strongest kind of
fear is fear of the unknown.

-- H.P. Lovecraft
                                                                                                                                                                                                                                                  I N F O R M H E A D

Please press SPACE to continue.

>test cabinet
(Testing.)

>[1] x cabinet
You can't see any such thing.

>[2] consult cabinet about foo
You can't see any such thing.

>[3] consult cabinet about verlac
You can't see any such thing.

>[4] g
You can't see any such thing.

>test window
(Testing.)

>[1] se

Alley
This narrow aperture between two buildings is nearly blocked with piles of rotting cardboard boxes and overstuffed garbage cans. Ugly, half-crumbling brick walls to either side totter oppressively over you. The alley ends here at a tall, wooden fence.

High up on the wall of the northern building there is a narrow, transom-style window. 

>[2] open window
(the window)
The window is too high.

>[3] look through window
(the window)
The window is too high.

>[4] stand on cans
You clamber onto the wobbling garbage can, precariously balanced.

>[5] look through window
(the window)
The window is too high.

>[6] open window
(the window)
Hmm. You still can't quite reach, because the garbage can is too far away from the wall. Perhaps if you pushed it closer...

>[7] enter window
(the window)
(first getting off the cans)
(first opening the window)
The window is too high.

>[8] enter window
(the window)
(first opening the window)
The window is too high.

>[9] nw

Outside the Real Estate Office
A grim little cul-de-sac, tucked away in a corner of the claustrophobic tangle of narrow, twisting avenues that largely constitute the older portion of Anchorhead. Like most of the streets in this city, it is ancient, shadowy, and leads essentially nowhere. The lane ends here at the real estate agent's office, which lies to the east, and winds its way back toward the center of town to the west. A narrow, garbage-choked alley opens to the southeast.

>w
Narrow Street
As the lane winds along from east to west, it narrows until the steep, jagged rooftops on either side of the street practically touch each other. To the south, a side street leads across Whateley Bridge toward the center of town, and a twisting lane leads up a hill to the northwest. A short flight of steps to the north leads down to the local watering hole.

>e
Outside the Real Estate Office
A grim little cul-de-sac, tucked away in a corner of the claustrophobic tangle of narrow, twisting avenues that largely constitute the older portion of Anchorhead. Like most of the streets in this city, it is ancient, shadowy, and leads essentially nowhere. The lane ends here at the real estate agent's office, which lies to the east, and winds its way back toward the center of town to the west. A narrow, garbage-choked alley opens to the southeast.

>l
Outside the Real Estate Office
A grim little cul-de-sac, tucked away in a corner of the claustrophobic tangle of narrow, twisting avenues that largely constitute the older portion of Anchorhead. Like most of the streets in this city, it is ancient, shadowy, and leads essentially nowhere. The lane ends here at the real estate agent's office, which lies to the east, and winds its way back toward the center of town to the west. A narrow, garbage-choked alley opens to the southeast.

>e
(first opening the office door)
It seems to be locked.

>test window
(Testing.)

>[1] se

Alley
This narrow aperture between two buildings is nearly blocked with piles of rotting cardboard boxes and overstuffed garbage cans. Ugly, half-crumbling brick walls to either side totter oppressively over you. The alley ends here at a tall, wooden fence.

High up on the wall of the northern building there is a narrow, transom-style window. 

>[2] open window
(the window)
The window is too high.

>[3] look through window
(the window)
The window is too high.

>[4] stand on cans
You clamber onto the wobbling garbage can, precariously balanced.

>[5] look through window
(the window)
The window is too high.

>[6] open window
(the window)
Hmm. You still can't quite reach, because the garbage can is too far away from the wall. Perhaps if you pushed it closer...

>[7] enter window
(the window)
(first getting off the cans)
(first opening the window)
The window is too high.

>[8] enter window
(the window)
(first opening the window)
The window is too high.

>[9] nw

Outside the Real Estate Office
A grim little cul-de-sac, tucked away in a corner of the claustrophobic tangle of narrow, twisting avenues that largely constitute the older portion of Anchorhead. Like most of the streets in this city, it is ancient, shadowy, and leads essentially nowhere. The lane ends here at the real estate agent's office, which lies to the east, and winds its way back toward the center of town to the west. A narrow, garbage-choked alley opens to the southeast.

>se. enter window.
Alley
This narrow aperture between two buildings is nearly blocked with piles of rotting cardboard boxes and overstuffed garbage cans. Ugly, half-crumbling brick walls to either side totter oppressively over you. The alley ends here at a tall, wooden fence.

High up on the wall of the northern building there is a narrow, transom-style window. 

(the window)
(first opening the window)
The window is too high.

>se. stand on cans. enter window. w.
You can only exit the alley to the northwest.

You clamber onto the wobbling garbage can, precariously balanced.

(the window)
(first getting off the cans)
(first opening the window)
The window is too high.

You can only exit the alley to the northwest.

>stand on cans
You clamber onto the wobbling garbage can, precariously balanced.

>enter window
(the window)
(first getting off the cans)
(first opening the window)
The window is too high.

>w
You can only exit the alley to the northwest.

>n
(first opening the window)
The window is too high.

* * *

>.x cabinet
That's not a verb I recognise.

>x cabinet
It's an ancient, clunky metal box, about the size of a kid's lunchbox. There's some sort of lettering on the cover, but it's too corroded to read.

>open it
It takes some grumbling and some tugging and finally a good, sharp yank, but the cabinet finally pops open.

>x cabinet
It's an ancient, clunky metal box, about the size of a kid's lunchbox. There's some sort of lettering on the cover, but it's too corroded to read.

In the fuse cabinet are some corroded fuse plugs.

>x plugs
There's about two dozen fuses lined up in there, the old-fashioned kind that look like round, glass plugs. Every last one of them is blown.

>take plugs
You pull one of the fuses out and try to rub some of the grime off. Sure enough, the little metal strip inside is melted to a black, twisted cinder. With a sigh, you plug it back into its socket.

>x cabinet
It's an ancient, clunky metal box, about the size of a kid's lunchbox. There's some sort of lettering on the cover, but it's too corroded to read.

In the fuse cabinet are some corroded fuse plugs.

>close cabinet
You close the fuse cabinet.

>x it
It's an ancient, clunky metal box, about the size of a kid's lunchbox. There's some sort of lettering on the cover, but it's too corroded to read.

>l
Cellar
The old, flagstone walls gleam with unwholesome-smelling moisture, and the sagging timbers creak uneasily above your head. Ancient, frayed wiring festoons the ceiling like some strange species of clinging vine. Portions of the cellar extend south and east into the clammy darkness, though you could always beat a hasty retreat up the stairs to the north.

One largish bundle of wires leads down to a rusty old fuse cabinet bolted to the far wall.

>s
You can't go that way.

* * *

>clean web with broom
With a single sweep of the broom, you clear the spider web away.

>l
Storage Room
Old crates and boxes piled high against the walls make this room seem even smaller and dingier than it actually is, which is saying a lot. A doorway lies north; the other walls contain nothing but shadows and dirt-filled corners.

You can see an old-fashioned iron key and a cardboard box (in which are some newspaper clippings) here.

>take key
(the old-fashioned iron key)
Taken.

>i
You are carrying:
  an old-fashioned iron key
  a broom
  a flashlight (providing light)
  a cellar key
  a house key
  your umbrella
  your keyring
  Michael's faculty card
  your clothes (being worn)
  your trenchcoat (being worn)
  your wedding ring (being worn)

>x iron key
It's an old key, the kind with a round barrel about a quarter-inch in diameter and flat, square teeth.

* * *

>clean web with broom
With a single sweep of the broom, you clear the spider web away.

>take key
(the old-fashioned iron key)
[Your score has just gone up by one point.]

* * *

>clean web with keyring
The keyring wouldn't be very effective.

* * *

>clean web with umbrella
The pointy end of the umbrella doesn't do much damage to the thick, tangled web.

>clean web with keyring
The keyring wouldn't be very effective.

>clean web with broom
Foo.

* * *

>i
You are carrying:
  a flashlight (providing light)
  a cellar key
  a house key
  your umbrella
  your keyring
  Michael's faculty card
  your clothes (being worn)
  your trenchcoat (being worn)
  your wedding ring (being worn)

>unlock cellar door with cellar key
You unlock the cdoor.

>d
(first opening the cdoor)

Cellar
The old, flagstone walls gleam with unwholesome-smelling moisture, and the sagging timbers creak uneasily above your head. Ancient, frayed wiring festoons the ceiling like some strange species of clinging vine. Portions of the cellar extend south and east into the clammy darkness, though you could always beat a hasty retreat up the stairs to the north.

One largish bundle of wires leads down to a rusty old fuse cabinet bolted to the far wall.

>s
Storage Room
Old crates and boxes piled high against the walls make this room seem even smaller and dingier than it actually is, which is saying a lot. A doorway lies north; the other walls contain nothing but shadows and dirt-filled corners.

>search crates
You spend some time poking dispiritedly through boxes of second-hand table settings, discarded shoes and outdated encyclopedias, but the only thing you manage to dig up is an old cardboard box full of newspaper clippings, which might make interesting reading later if you can find the time. The only thing at all noteworthy about the room, in fact, is that it desperately wants cleaning; there's even a big, nasty-looking spider web in a corner behind one of the crates.

>l
Storage Room
Old crates and boxes piled high against the walls make this room seem even smaller and dingier than it actually is, which is saying a lot. A doorway lies north; the other walls contain nothing but shadows and dirt-filled corners.

A nasty-looking spider web fills one dark corner like some sort of sticky, fibrous mold.

You can also see a cardboard box (in which are some newspaper clippings) here.

>x clippings
It's an old gray shoebox, ragged around the edges, with the lid missing.

>read it
Nothing is written on the spider web.

* * *

>take clippings
The box seems old and crumbling. It probably wouldn't survive the journey.

* * *

>s
Storage Room
Old crates and boxes piled high against the walls make this room seem even smaller and dingier than it actually is, which is saying a lot. A doorway lies north; the other walls contain nothing but shadows and dirt-filled corners.

* * *

>l
Storage Room
Old crates and boxes piled high against the walls make this room seem even smaller and dingier than it actually is, which is saying a lot. A doorway lies north; the other walls contain nothing but shadows and dirt-filled corners.

A nasty-looking spider web fills one dark corner like some sort of sticky, fibrous mold.

You can also see a cardboard box (in which are some newspaper clippings) here.

>x web
Not a pretty, symmetrical spiral web like you see in nature magazines; this is a tangled, ugly mass of dull gray threads spun in every direction, the work of some careless, inebriated arachnid on a weekend binger. Way back in the corner, almost buried beneath the disheveled strands, is an old-fashioned iron key.

* * *

>search crates
You spend some time poking dispiritedly through boxes of second-hand table settings, discarded shoes and outdated encyclopedias, but the only thing you manage to dig up is an old cardboard box full of newspaper clippings, which might make interesting reading later if you can find the time. The only thing at all noteworthy about the room, in fact, is that it desperately wants cleaning; there's even a big, nasty-looking spider web in a corner behind one of the crates.

>x web
Not a pretty, symmetrical spiral web like you see in nature magazines; this is a tangled, ugly mass of dull gray threads spun in every direction, the work of some careless, inebriated arachnid on a weekend binger. Way back in the corner, almost buried beneath the disheveled strands, is an old-fashioned iron key.

>l
Storage Room
Old crates and boxes piled high against the walls make this room seem even smaller and dingier than it actually is, which is saying a lot. A doorway lies north; the other walls contain nothing but shadows and dirt-filled corners.

A nasty-looking spider web fills one dark corner like some sort of sticky, fibrous mold.

You can also see a cardboard box (in which are some newspaper clippings) here.

>clean web
You gingerly stick your hand into the tangled spider web, and something light and skittery crawls across your skin and bites you!

Quickly you jerk back, compulsively wiping your hand on your pants. The bite itself didn't hurt all that much, but the thought of spiders crawling around on your skin gives you the willies.

>showme player
There seems to be no such object anywhere in the model world.

>showme self
yourself - person
    flashlight - device
    cellar key
    house key
    keyring - open container
    Michael's faculty card
    clothes (worn)
    trenchcoat (worn)
    wedding ring (worn)
location: in the Storage Room
unlit, inedible, portable; transparent, male; singular-named, proper-named
description: "As good-looking as ever."
initial appearance: none
printing: "blank"
carrying capacity: 100
printed name: "yourself"
printed plural name: "people"
indefinite article: none
list grouping key: none
day: 2
spider: 58

>n
Cellar
The old, flagstone walls gleam with unwholesome-smelling moisture, and the sagging timbers creak uneasily above your head. Ancient, frayed wiring festoons the ceiling like some strange species of clinging vine. Portions of the cellar extend south and east into the clammy darkness, though you could always beat a hasty retreat up the stairs to the north.

One largish bundle of wires leads down to a rusty old fuse cabinet bolted to the far wall.

>u
Pantry
The pantry is empty save for a layer of dust on the shelves. A door to the south leads down to the cellar, or you can return to the kitchen to the southeast.

Leaning in the corner is an old broom.

>se
Kitchen
Where once pots and skillets and various utensils hung in profusion, the kitchen walls are now merely ranks of dusty cabinets and a forest of empty hooks. Doorways lead east and south, a small pantry lies to the northwest, and the back door to the north leads out of the house.

>e
Back Hall
A short hallway, connecting rooms to the east, west and south.

>s
Foyer
Although it appears spacious from the outside, the house's interior feels cramped and gloomy. The walls seem too close together; the ceiling is too high. The doorways, leading in several directions, are narrow and filled with shadows, and the stairs leading up to the second floor are steep and rickety. This is not a house that makes you feel welcome. It is a house that makes you feel tiny and timid, and afraid of dark places. It is a house that makes you feel alone.

Your luggage is still here, spread out all over the foyer.

>showme self
yourself - person
    flashlight - device
    cellar key
    house key
    keyring - open container
    Michael's faculty card
    clothes (worn)
    trenchcoat (worn)
    wedding ring (worn)
location: in Foyer
unlit, inedible, portable; transparent, male; singular-named, proper-named
description: "As good-looking as ever."
initial appearance: none
printing: "blank"
carrying capacity: 100
printed name: "yourself"
printed plural name: "people"
indefinite article: none
list grouping key: none
day: 2
spider: 58

>turn count
You can't see any such thing.

* * *

>s
Storage Room
Old crates and boxes piled high against the walls make this room seem even smaller and dingier than it actually is, which is saying a lot. A doorway lies north; the other walls contain nothing but shadows and dirt-filled corners.

>x crates
The accumulated junk of almost four centuries" worth of one family's strangeness. Most of it is old linens, moth-eaten clothes, newspaper clippings -- exciting stuff like that. There's far more here than you could ever go through, even if you had the inclination to.

>clean web
You can't see any such thing.

>search crates. clean web.
You spend some time poking dispiritedly through boxes of second-hand table settings, discarded shoes and outdated encyclopedias, but the only thing you manage to dig up is an old cardboard box full of newspaper clippings, which might make interesting reading later if you can find the time. The only thing at all noteworthy about the room, in fact, is that it desperately wants cleaning; there's even a big, nasty-looking spider web in a corner behind one of the crates.

You gingerly stick your hand into the tangled spider web, and something light and skittery crawls across your skin and bites you!

Quickly you jerk back, compulsively wiping your hand on your pants. The bite itself didn't hurt all that much, but the thought of spiders crawling around on your skin gives you the willies.

Spider = 0

>n
Cellar
The old, flagstone walls gleam with unwholesome-smelling moisture, and the sagging timbers creak uneasily above your head. Ancient, frayed wiring festoons the ceiling like some strange species of clinging vine. Portions of the cellar extend south and east into the clammy darkness, though you could always beat a hasty retreat up the stairs to the north.

One largish bundle of wires leads down to a rusty old fuse cabinet bolted to the far wall.

Spider = -1

>u
Pantry
The pantry is empty save for a layer of dust on the shelves. A door to the south leads down to the cellar, or you can return to the kitchen to the southeast.

Leaning in the corner is an old broom.

Spider = -2

* * *

>x crates
The accumulated junk of almost four centuries" worth of one family's strangeness. Most of it is old linens, moth-eaten clothes, newspaper clippings -- exciting stuff like that. There's far more here than you could ever go through, even if you had the inclination to.

>search crates
You spend some time poking dispiritedly through boxes of second-hand table settings, discarded shoes and outdated encyclopedias, but the only thing you manage to dig up is an old cardboard box full of newspaper clippings, which might make interesting reading later if you can find the time. The only thing at all noteworthy about the room, in fact, is that it desperately wants cleaning; there's even a big, nasty-looking spider web in a corner behind one of the crates.

* * *

>l
Storage Room
Old crates and boxes piled high against the walls make this room seem even smaller and dingier than it actually is, which is saying a lot. A doorway lies north; the other walls contain nothing but shadows and dirt-filled corners.

A nasty-looking spider web fills one dark corner like some sort of sticky, fibrous mold.

You can also see a cardboard box (in which are some newspaper clippings) here.

>x web
You can't see any such thing.

* * *

>x crates
The accumulated junk of almost four centuries" worth of one family's strangeness. Most of it is old linens, moth-eaten clothes, newspaper clippings -- exciting stuff like that. There's far more here than you could ever go through, even if you had the inclination to.

>search it
You spend some time poking dispiritedly through boxes of second-hand table settings, discarded shoes and outdated encyclopedias, but the only thing you manage to dig up is an old cardboard box full of newspaper clippings, which might make interesting reading later if you can find the time. The only thing at all noteworthy about the room, in fact, is that it desperately wants cleaning; there's even a big, nasty-looking spider web in a corner behind one of the crates.

>clean web
You rub the spider web.

>clean web with keyring
The keyring isn't great for cleaning.

* * *

>s. search crates. clean web.
Storage Room
Old crates and boxes piled high against the walls make this room seem even smaller and dingier than it actually is, which is saying a lot. A doorway lies north; the other walls contain nothing but shadows and dirt-filled corners.

You spend some time poking dispiritedly through boxes of second-hand table settings, discarded shoes and outdated encyclopedias, but the only thing you manage to dig up is an old cardboard box full of newspaper clippings, which might make interesting reading later if you can find the time. The only thing at all noteworthy about the room, in fact, is that it desperately wants cleaning; there's even a big, nasty-looking spider web in a corner behind one of the crates.

You gingerly stick your hand into the tangled spider web, and something light and skittery crawls across your skin and bites you!

Quickly you jerk back, compulsively wiping your hand on your pants. The bite itself didn't hurt all that much, but the thought of spiders crawling around on your skin gives you the willies.

Spider = 0

>n
Cellar
The old, flagstone walls gleam with unwholesome-smelling moisture, and the sagging timbers creak uneasily above your head. Ancient, frayed wiring festoons the ceiling like some strange species of clinging vine. Portions of the cellar extend south and east into the clammy darkness, though you could always beat a hasty retreat up the stairs to the north.

One largish bundle of wires leads down to a rusty old fuse cabinet bolted to the far wall.

Spider = 1

>u
Pantry
The pantry is empty save for a layer of dust on the shelves. A door to the south leads down to the cellar, or you can return to the kitchen to the southeast.

Leaning in the corner is an old broom.

Spider = 2

>e
You can't go that way.

Spider = 3A wave of dizziness washes over you suddenly, making you light-headed. Your hand is swollen and throbbing a little, and your skin is flushed with an unpleasant, prickly heat. It occurs to you to wonder whether the spider that bit you might have been poisonous.

>e
You can't go that way.

Spider = 4

>se
Kitchen
Where once pots and skillets and various utensils hung in profusion, the kitchen walls are now merely ranks of dusty cabinets and a forest of empty hooks. Doorways lead east and south, a small pantry lies to the northwest, and the back door to the north leads out of the house.

Spider = 5The dizziness hits you again, and you sway as little black ink blots bloom in your vision. Your hand is really hurting now, and you feel short of breath.

>e
Back Hall
A short hallway, connecting rooms to the east, west and south.

Spider = 6

>s
Foyer
Although it appears spacious from the outside, the house's interior feels cramped and gloomy. The walls seem too close together; the ceiling is too high. The doorways, leading in several directions, are narrow and filled with shadows, and the stairs leading up to the second floor are steep and rickety. This is not a house that makes you feel welcome. It is a house that makes you feel tiny and timid, and afraid of dark places. It is a house that makes you feel alone.

Your luggage is still here, spread out all over the foyer.

Spider = 7You are burning up; you can barely see through the waves of blackness washing across your vision. You try to sit down, only to realize that you're already lying on the ground, unable to move. In a disconnected, feverish haze, you vaguely wonder if Michael will find you in time to call the hospital; and that is your last thought before feeling leaves your limbs and your lungs stop working entirely.

    *** You have died. ***

In that game you scored 4 out of a possible 0, in 63 turns.

Would you like to RESTART, RESTORE a saved game, QUIT or UNDO the last command?

* * *

>x cabinet
It's an ancient, clunky metal box, about the size of a kid's lunchbox. There's some sort of lettering on the cover, but it's too corroded to read.

* * *

>open it
It takes some grumbling and some tugging and finally a good, sharp yank, but the cabinet finally pops open.

>close it
You close the fuse cabinet.

>open it
You open the fuse cabinet, revealing a fuse plugs.

>x plugs
There's about two dozen fuses lined up in there, the old-fashioned kind that look like round, glass plugs. Every last one of them is blown.

* * *

>take plugs
You pull one of the fuses out and try to rub some of the grime off. Sure enough, the little metal strip inside is melted to a black, twisted cinder. With a sigh, you plug it back into its socket.

>i
You are carrying:
  a flashlight (providing light)
  a cellar key
  a house key
  your keyring
  Michael's faculty card
  your clothes (being worn)
  your trenchcoat (being worn)
  your wedding ring (being worn)

>l
Cellar
The old, flagstone walls gleam with unwholesome-smelling moisture, and the sagging timbers creak uneasily above your head. Ancient, frayed wiring festoons the ceiling like some strange species of clinging vine. Portions of the cellar extend south and east into the clammy darkness, though you could always beat a hasty retreat up the stairs to the north.

One largish bundle of wires leads down to a rusty old fuse cabinet bolted to the far wall.

>x cabinet
It's an ancient, clunky metal box, about the size of a kid's lunchbox. There's some sort of lettering on the cover, but it's too corroded to read.

In the fuse cabinet is a fuse plugs.

* * *

>close william's
As you move to replace the lid, you shudder at the grisly memory of opening it in the first place. Best leave the coffin as it is.

>close william's
As you move to replace the lid, you shudder at the grisly memory of opening it in the first place. Best leave the coffin as it is.

>open it
That's already open.

>ls -l
That's not a verb I recognise.

>ktake bones
That's not a verb I recognise.

>take bones
The skeleton is in pieces; parts of it crumble even as you touch it. Only the animal's skull seems reasonably intact.

>x bones
You're no veterinarian, but these cannot possibly be the bones of a human child. A dog seems most likely, at a rough guess.

>take skull
You take the animal's skull. The gruesome thing seems to leer at you with its bleached, toothy grin..

>x bones
You're no veterinarian, but these cannot possibly be the bones of a human child. A dog seems most likely, at a rough guess.

>take bones
The skeleton is in pieces; parts of it crumble even as you touch it.

>i
You are carrying:
  an animal's skull
  an old-fashioned iron key
  a flashlight (providing light)
  a cellar key
  a house key
  your umbrella
  your keyring
  Michael's faculty card
  your clothes (being worn)
  your trenchcoat (being worn)
  your wedding ring (being worn)

>drop skull
Dropped.

>l
In the Crypt
The air is clammy and frigid, the stone walls damp and streaked with mud and lichen. Pale, swollen roots push through cracks in the masonry. The smell of damp corruption is almost overpowering here, though the stairs to the south lead toward fresher air.

The walls of this chamber contain dozens of wide, shallow niches; in each niche, a coffin.

You can see an animal's skull here.

>take skull
You take the animal's skull.

* * *

>consult nameplate about edward
The nameplate reads "Edward Verlac, b. April 26, 1960, d. March 14, 1997". Like the others, this coffin is built of solid oak, sealed with lead.

>x edward's
Like the others, this coffin is built of solid oak, sealed with lead.

>consult nameplate about william
The nameplate reads "William Verlac, b. June 22, 1954, d. September 18, 1958". Unlike the others, William's coffin is a ramshackle affair of cheap pine, held together with rusting nails. It's half-rotten with age and so shabbily built you could probably open it with your bare hands.

>open william's
Compelled by a gruesome curiosity, you dig your fingers under the soft, rotting boards and pry up the lid. With the shriek of pulling nails and a shower of crumbling wood, the coffin comes open, and you look inside, expecting to find a child's tiny skeleton...

Dear God.

There's no child buried here. Instead, the coffin contains only the worm-eaten bones of some kind of animal.

Who would have buried an animal in place of the child that should have been interred here? And why would they do such a thing? Glumly, you look around at the rest of the coffins, and realize that anyone who might have known the answers to these questions is probably already buried in this room.

>take bones
The skeleton is in pieces; parts of it crumble even as you touch it. Only the animal's skull seems reasonably intact.

>take skull
You take the animal's skull. The gruesome thing seems to leer at you with its bleached, toothy grin..

>x william
You can't see any such thing.

>x william's
Unlike the others, William's coffin is a ramshackle affair of cheap pine, held together with rusting nails. It's half-rotten with age and so shabbily built you could probably open it with your bare hands.

>l
In the Crypt
The air is clammy and frigid, the stone walls damp and streaked with mud and lichen. Pale, swollen roots push through cracks in the masonry. The smell of damp corruption is almost overpowering here, though the stairs to the south lead toward fresher air.

The walls of this chamber contain dozens of wide, shallow niches; in each niche, a coffin.

* * *

>consult nameplate about william
The nameplate reads "William Verlac, b. June 22, 1954, d. September 18, 1958". Unlike the others, William's coffin is a ramshackle affair of cheap pine, held together with rusting nails. It's half-rotten with age and so shabbily built you could probably open it with your bare hands..

>x william's
Unlike the others, William's coffin is a ramshackle affair of cheap pine, held together with rusting nails. It's half-rotten with age and so shabbily built you could probably open it with your bare hands.

>open it
It isn't something you can open.

>l
In the Crypt
The air is clammy and frigid, the stone walls damp and streaked with mud and lichen. Pale, swollen roots push through cracks in the masonry. The smell of damp corruption is almost overpowering here, though the stairs to the south lead toward fresher air.

The walls of this chamber contain dozens of wide, shallow niches; in each niche, a coffin.

>x william's
Unlike the others, William's coffin is a ramshackle affair of cheap pine, held together with rusting nails. It's half-rotten with age and so shabbily built you could probably open it with your bare hands.

>look in william's
Carefully pushing the prickly branches aside, you find a rusty metal hatch set into the base of the wall.

* * *

>open it
It isn't something you can open.

>x it
Unlike the others, William's coffin is a ramshackle affair of cheap pine, held together with rusting nails. It's half-rotten with age.

>l
In the Crypt
The air is clammy and frigid, the stone walls damp and streaked with mud and lichen. Pale, swollen roots push through cracks in the masonry. The smell of damp corruption is almost overpowering here, though the stairs to the south lead toward fresher air.

The walls of this chamber contain dozens of wide, shallow niches; in each niche, a coffin.

You're no veterinarian, but these cannot possibly be the bones of a human child. A dog seems most likely, at a rough guess.

* * *

>consult nameplate about william
The nameplate reads "William Verlac, b. June 22, 1954, d. September 18, 1958". Unlike the others, William's coffin is a ramshackle affair of cheap pine, held together with rusting nails. It's half-rotten with age and so shabbily built you could probably open it with your bare hands..

>x williams
You can't see any such thing.

>x william's
Unlike the others, William's coffin is a ramshackle affair of cheap pine, held together with rusting nails. It's half-rotten with age and so shabbily built you could probably open it with your bare hands.

* * *

>open it
It isn't something you can open.

>x it
Unlike the others, William's coffin is a ramshackle affair of cheap pine, held together with rusting nails. It's half-rotten with age and so shabbily built you could probably open it with your bare hands.

* * *

>consult nameplate about william's
You can't find that name anywhere; but then again, it may just be too corroded for you to read.

>consult nameplate about william
The nameplate reads "William Verlac, b. June 22, 1954, d. September 18, 1958". Unlike the others, William's coffin is a ramshackle affair of cheap pine, held together with rusting nails. It's half-rotten with age and so shabbily built you could probably open it with your bare hands..

>l
In the Crypt
The air is clammy and frigid, the stone walls damp and streaked with mud and lichen. Pale, swollen roots push through cracks in the masonry. The smell of damp corruption is almost overpowering here, though the stairs to the south lead toward fresher air.

The walls of this chamber contain dozens of wide, shallow niches; in each niche, a coffin.

>x williams coffin
You can't see any such thing.

>x williams
You can't see any such thing.

* * *

>x william's
Unlike the others, William's coffin is a ramshackle affair of cheap pine, held together with rusting nails. It's half-rotten with age and so shabbily built you could probably open it with your bare hands.

>open it
Compelled by a gruesome curiosity, you dig your fingers under the soft, rotting boards and pry up the lid. With the shriek of pulling nails and a shower of crumbling wood, the coffin comes open, and you look inside, expecting to find a child's tiny skeleton...

Dear God.

There's no child buried here. Instead, the coffin contains only the worm-eaten bones of some kind of animal.

Who would have buried an animal in place of the child that should have been interred here? And why would they do such a thing? Glumly, you look around at the rest of the coffins, and realize that anyone who might have known the answers to these questions is probably already buried in this room.

You open William's Coffin.

>x william's
Unlike the others, William's coffin is a ramshackle affair of cheap pine, held together with rusting nails. It's half-rotten with age.

>l
In the Crypt
The air is clammy and frigid, the stone walls damp and streaked with mud and lichen. Pale, swollen roots push through cracks in the masonry. The smell of damp corruption is almost overpowering here, though the stairs to the south lead toward fresher air.

The walls of this chamber contain dozens of wide, shallow niches; in each niche, a coffin.

>look in william's
William's Coffin is empty.

* * *

>i
You are carrying:
  an old-fashioned iron key
  a flashlight (providing light)
  a cellar key
  a house key
  your umbrella
  your keyring
  Michael's faculty card
  your clothes (being worn)
  your trenchcoat (being worn)
  your wedding ring (being worn)

>nw. unlock crypt door.
Stooping to avoid the sharp, bare twigs that snag your clothes and seem to reach greedily for your eyes, you pick your way through the undergrowth to a small clearing.

Family Plot
Old, moss-slimed tombstones, many broken off and leaning crazily like an old man's teeth, poke up from the soft, mulchy earth. In their midst stands an ancient marble crypt, its heavy iron door nearly obscured by thick draperies of ivy. The trees press close around this quiet enclave of death, leaning together over your head as if sharing secrets. A gap in the undergrowth to the southeast reveals a narrow gravel path.

(with the old-fashioned iron key)
You unlock the crypt door.

>n
You can't go that way.

>d
(first opening the crypt door)

In the Crypt

>l
In the Crypt

* * *

>ne. unlock door. d.
You can't go that way.

That's unlocked at the moment.

You can't go that way.

>nw. unlock door. d.
Stooping to avoid the sharp, bare twigs that snag your clothes and seem to reach greedily for your eyes, you pick your way through the undergrowth to a small clearing.

Family Plot
Old, moss-slimed tombstones, many broken off and leaning crazily like an old man's teeth, poke up from the soft, mulchy earth. In their midst stands an ancient marble crypt, its heavy iron door nearly obscured by thick draperies of ivy. The trees press close around this quiet enclave of death, leaning together over your head as if sharing secrets. A gap in the undergrowth to the southeast reveals a narrow gravel path.

(with the old-fashioned iron key)
You unlock the crypt door.

(first opening the crypt door)

In the Crypt
The air is clammy and frigid, the stone walls damp and streaked with mud and lichen. Pale, swollen roots push through cracks in the masonry. The smell of damp corruption is almost overpowering here, though the stairs to the south lead toward fresher air.

The walls of this chamber contain dozens of wide, shallow niches; in each niche, a coffin.

>i
You are carrying:
  an old-fashioned iron key
  a flashlight (providing light)
  a cellar key
  a house key
  your umbrella
  your keyring
  Michael's faculty card
  your clothes (being worn)
  your trenchcoat (being worn)
  your wedding ring (being worn)

>turn off light
You switch the flashlight off.

It is now pitch dark in here!

>l
Darkness
It is pitch dark, and you can't see a thing.

>turn on light
You switch the flashlight on.

In the Crypt
The air is clammy and frigid, the stone walls damp and streaked with mud and lichen. Pale, swollen roots push through cracks in the masonry. The smell of damp corruption is almost overpowering here, though the stairs to the south lead toward fresher air.

The walls of this chamber contain dozens of wide, shallow niches; in each niche, a coffin.

>x william
You can't see any such thing.

* * *

>nw
Stooping to avoid the sharp, bare twigs that snag your clothes and seem to reach greedily for your eyes, you pick your way through the undergrowth to a small clearing.

Family Plot
Old, moss-slimed tombstones, many broken off and leaning crazily like an old man's teeth, poke up from the soft, mulchy earth. In their midst stands an ancient marble crypt, its heavy iron door nearly obscured by thick draperies of ivy. The trees press close around this quiet enclave of death, leaning together over your head as if sharing secrets. A gap in the undergrowth to the southeast reveals a narrow gravel path.

>se
Path Behind the House
A gravel path starts here at the back door of the house, and marks a trail nearly overgrown by weeds and briars. It disappears into the undergrowth to the northwest, framed by crooked trees with overhanging branches that seem to form a stunted, jagged archway into the dim recesses of the forest.

You can see a back door here.

>nw
Stooping to avoid the sharp, bare twigs that snag your clothes and seem to reach greedily for your eyes, you pick your way through the undergrowth to a small clearing.

Family Plot
Old, moss-slimed tombstones, many broken off and leaning crazily like an old man's teeth, poke up from the soft, mulchy earth. In their midst stands an ancient marble crypt, its heavy iron door nearly obscured by thick draperies of ivy. The trees press close around this quiet enclave of death, leaning together over your head as if sharing secrets. A gap in the undergrowth to the southeast reveals a narrow gravel path.

You can see a crypt door here.

>x tombstones
Years of neglect have left the tombstones in bad repair -- the ones not broken are eroded to near-illegibility, and those not eroded are covered with thick, sticky moss. From what you can make out, though, most of them are servants" graves. Family members were most likely buried in the larger structure in the middle of the clearing.

>x crypt
(the crypt door)
You see nothing special about the crypt door.

>x door
(the crypt door)
You see nothing special about the crypt door.

* * *

>unlock door
That doesn't seem to be something you can unlock.

* * *

>x crypt
Grimly carved letters over the door spell out a single name: "VERLAC".

>x crypt door
Grimly carved letters over the door spell out a single name: "VERLAC".

>unlock door
You lack a key that fits the crypt door.

>i
You are carrying:
  a flashlight
  a cellar key
  a house key
  your umbrella
  your keyring
  Michael's faculty card
  your clothes (being worn)
  your trenchcoat (being worn)
  your wedding ring (being worn)

* * *

>nw. unlock door. d.
Stooping to avoid the sharp, bare twigs that snag your clothes and seem to reach greedily for your eyes, you pick your way through the undergrowth to a small clearing.

Family Plot
Old, moss-slimed tombstones, many broken off and leaning crazily like an old man's teeth, poke up from the soft, mulchy earth. In their midst stands an ancient marble crypt, its heavy iron door nearly obscured by thick draperies of ivy. The trees press close around this quiet enclave of death, leaning together over your head as if sharing secrets. A gap in the undergrowth to the southeast reveals a narrow gravel path.

(with the old-fashioned iron key)
You unlock the crypt door.

(first opening the crypt door)

In the Crypt
The air is clammy and frigid, the stone walls damp and streaked with mud and lichen. Pale, swollen roots push through cracks in the masonry. The smell of damp corruption is almost overpowering here, though the stairs to the south lead toward fresher air.

The walls of this chamber contain dozens of wide, shallow niches; in each niche, a coffin.

>x william's
Unlike the others, William's coffin is a ramshackle affair of cheap pine, held together with rusting nails. It's half-rotten with age and so shabbily built you could probably open it with your bare hands.

>open it
Compelled by a gruesome curiosity, you dig your fingers under the soft, rotting boards and pry up the lid. With the shriek of pulling nails and a shower of crumbling wood, the coffin comes open, and you look inside, expecting to find a child's tiny skeleton...

Dear God.

There's no child buried here. Instead, the coffin contains only the worm-eaten bones of some kind of animal.

Who would have buried an animal in place of the child that should have been interred here? And why would they do such a thing? Glumly, you look around at the rest of the coffins, and realize that anyone who might have known the answers to these questions is probably already buried in this room.

>l
In the Crypt
The air is clammy and frigid, the stone walls damp and streaked with mud and lichen. Pale, swollen roots push through cracks in the masonry. The smell of damp corruption is almost overpowering here, though the stairs to the south lead toward fresher air.

The walls of this chamber contain dozens of wide, shallow niches; in each niche, a coffin.

>x bones
You're no veterinarian, but these cannot possibly be the bones of a human child. A dog seems most likely, at a rough guess.

>take bones
The skeleton is in pieces; parts of it crumble even as you touch it. Only the animal's skull seems reasonably intact.

>l
In the Crypt
The air is clammy and frigid, the stone walls damp and streaked with mud and lichen. Pale, swollen roots push through cracks in the masonry. The smell of damp corruption is almost overpowering here, though the stairs to the south lead toward fresher air.

The walls of this chamber contain dozens of wide, shallow niches; in each niche, a coffin.

You can see an animal's skull here.

>take skull
You take the animal's skull. The gruesome thing seems to leer at you with its bleached, toothy grin..

>l
In the Crypt
The air is clammy and frigid, the stone walls damp and streaked with mud and lichen. Pale, swollen roots push through cracks in the masonry. The smell of damp corruption is almost overpowering here, though the stairs to the south lead toward fresher air.

The walls of this chamber contain dozens of wide, shallow niches; in each niche, a coffin.

>u
You involuntary take a deep breath of fresh air as you leave the clammy, foetid depths of the crypt behind.

Family Plot
Old, moss-slimed tombstones, many broken off and leaning crazily like an old man's teeth, poke up from the soft, mulchy earth. In their midst stands an ancient marble crypt, its heavy iron door nearly obscured by thick draperies of ivy. The trees press close around this quiet enclave of death, leaning together over your head as if sharing secrets. A gap in the undergrowth to the southeast reveals a narrow gravel path.

>se
Path Behind the House
A gravel path starts here at the back door of the house, and marks a trail nearly overgrown by weeds and briars. It disappears into the undergrowth to the northwest, framed by crooked trees with overhanging branches that seem to form a stunted, jagged archway into the dim recesses of the forest.

>turn off light
You switch the flashlight off.

>s
Kitchen
Where once pots and skillets and various utensils hung in profusion, the kitchen walls are now merely ranks of dusty cabinets and a forest of empty hooks. Doorways lead east and south, a small pantry lies to the northwest, and the back door to the north leads out of the house.

>e
Back Hall
A short hallway, connecting rooms to the east, west and south.

* * *

>open william's
That's already open.

>close it
You close William's Coffin.

>open william's
You've already done that, and you'll never forget it. You briefly shudder at the memory.

You open William's Coffin.

* * *

>showme william;s
There seems to be no such object anywhere in the model world.

>showme william's
William's Coffin - closed container
location: in In the Crypt
unlit, inedible, fixed in place, scenery; opaque, closed, openable, unlocked; singular-named, proper-named
description: "Unlike the others, William's coffin is a ramshackle affair of cheap pine, held together with rusting nails. It's half-rotten with age and so shabbily built you could probably open it with your bare hands."
initial appearance: none
last turn examined: 71
printing: "blank"
carrying capacity: 100
printed name: "William's Coffin"
printed plural name: "containers"
indefinite article: none
list grouping key: none

* * *

>take bones
The skeleton is in pieces; parts of it crumble even as you touch it. Only the animal's skull seems reasonably intact.

* * *

>x bones
You're no veterinarian, but these cannot possibly be the bones of a human child. A dog seems most likely, at a rough guess.

>l
In the Crypt
The air is clammy and frigid, the stone walls damp and streaked with mud and lichen. Pale, swollen roots push through cracks in the masonry. The smell of damp corruption is almost overpowering here, though the stairs to the south lead toward fresher air.

The walls of this chamber contain dozens of wide, shallow niches; in each niche, a coffin.

>take skull
You take the animal's skull. The gruesome thing seems to leer at you with its bleached, toothy grin..

* * *

>x trees
The woods are ancient, thick with undergrowth and full of shadows. Branches creak, leaves rustle beneath unseen, half-imagined footsteps, and strange birdcalls echo through the trees.

>x road
Out here, beyond the boundaries of the city proper, the cobblestones have given way to unpaved dirt.

>nw
You can't go that way.

>n
You can't go that way.

>w
You can't go that way.

>l
Path Behind the House
A gravel path starts here at the back door of the house, and marks a trail nearly overgrown by weeds and briars. It disappears into the undergrowth to the northwest, framed by crooked trees with overhanging branches that seem to form a stunted, jagged archway into the dim recesses of the forest.

You can see a back door here.

* * *

>x william's
Unlike the others, William's coffin is a ramshackle affair of cheap pine, held together with rusting nails. It's half-rotten with age.

>consult nameplate about william
The nameplate reads "William Verlac, b. June 22, 1954, d. September 18, 1958".

Unlike the others, William's coffin is a ramshackle affair of cheap pine, held together with rusting nails. It's half-rotten with age and so shabbily built you could probably open it with your bare hands.

>x william's
Unlike the others, William's coffin is a ramshackle affair of cheap pine, held together with rusting nails. It's half-rotten with age and so shabbily built you could probably open it with your bare hands.

>consult nameplate about heinrich
You can't find that name anywhere; but then again, it may just be too corroded for you to read.

>consult nameplate about edward
Like the others, this coffin is built of solid oak, sealed with lead.

* * *

>x william's
Unlike the others, William's coffin is a ramshackle affair of cheap pine, held together with rusting nails. It's half-rotten with age.

>open william's
That's already open.

* * *

>l
Master Bedroom (on the bed)
The master bedroom is a picture-postcard of rustic New England charm. Faded sketches of rural landscapes adorn the walls; a beautifully carved dressing mirror stands in one corner; an old-fashioned accordion radiator gurgles quietly beneath the window. The most striking feature, an enormous, antique, four-poster bed, must be the largest piece of furniture in the house.

On the four-poster bed you can see Michael's pants.

You can also see your wedding ring, your trenchcoat, your clothes, your keyring (empty), your umbrella, a house key and a cellar key here.

>i
You are carrying nothing.

* * *

>l
Master Bedroom (on the bed)
The master bedroom is a picture-postcard of rustic New England charm. Faded sketches of rural landscapes adorn the walls; a beautifully carved dressing mirror stands in one corner; an old-fashioned accordion radiator gurgles quietly beneath the window. The most striking feature, an enormous, antique, four-poster bed, must be the largest piece of furniture in the house.

On the four-poster bed you can see Michael's pants.

You can also see your wedding ring, your trenchcoat, your clothes, your keyring (empty), your umbrella, a house key and a cellar key here.

>stand
You get off the bed.

Master Bedroom
The master bedroom is a picture-postcard of rustic New England charm. Faded sketches of rural landscapes adorn the walls; a beautifully carved dressing mirror stands in one corner; an old-fashioned accordion radiator gurgles quietly beneath the window. The most striking feature, an enormous, antique, four-poster bed, must be the largest piece of furniture in the house.

On the four-poster bed you can see Michael's pants.

You can also see a keyring, a house key and a cellar key here.

>take all
Michael's pants: Taken.
keyring: Taken.
house key: Taken.
cellar key: Taken.
Michael's wallet: Taken.
Michael's faculty card: The shower suddenly stops. Quickly you palm the card, replace the wallet and arrange the pants the way you found them. A moment later Michael emerges from the bathroom, toweling his hair. "My, don't you look tempting this morning," he says, giving you a kiss. He tosses the towel back into the bathroom and gets dressed. "I think I'm going to stay home and get some writing done. I don't actually start work until tomorrow, so..." He kisses you on the cheek as he walks out into the hall. "If you go out today, see if you can find a newspaper. I want to learn as much as I can about this town."

He looks at you for a moment, and his voice becomes serious. "I love you, hon. You know that, don't you? I really want us to try and be happy here."

Then he turns and pads down the hall.

You take a deep breath as he goes. You've never lied to Michael or hidden anything from him before, ever; now, hardly two days into your new life, you're already sneaking through his wallet.

Oh yeah. You're off to a great start.

>l
Master Bedroom
The master bedroom is a picture-postcard of rustic New England charm. Faded sketches of rural landscapes adorn the walls; a beautifully carved dressing mirror stands in one corner; an old-fashioned accordion radiator gurgles quietly beneath the window. The most striking feature, an enormous, antique, four-poster bed, must be the largest piece of furniture in the house.

>i
You are carrying:
  Michael's faculty card
  a cellar key
  a house key
  a keyring
  your clothes (being worn)
  your trenchcoat (being worn)
  your wedding ring (being worn)

* * *

>restart
Are you sure you want to restart?

>y
Informhead
An Interactive Fiction by Ed Peters
Release 1 / Serial number 230515 / Inform 7 v10.1.2 / D

Outside the Real Estate Office
A grim little cul-de-sac, tucked away in a corner of the claustrophobic tangle of narrow, twisting avenues that largely constitute the older portion of Anchorhead. Like most of the streets in this city, it is ancient, shadowy, and leads essentially nowhere. The lane ends here at the real estate agent's office, which lies to the east, and winds its way back toward the center of town to the west. A narrow, garbage-choked alley opens to the southeast.

* * *

>test msleeps.
(Testing.)

>[1] u

Upstairs Landing
A narrow hallway runs east, from the top of the stairs down the length of the house. To the north, directly opposite the stairs, is the master bedroom.

>[2] n

Master Bedroom
The master bedroom is a picture-postcard of rustic New England charm. Faded sketches of rural landscapes adorn the walls; a beautifully carved dressing mirror stands in one corner; an old-fashioned accordion radiator gurgles quietly beneath the window. The most striking feature, an enormous, antique, four-poster bed, must be the largest piece of furniture in the house.

If it weren't for this hopelessly backwater town and the disturbing circumstances surrounding the house, you'd say this was your dream home. Even so, as much as you would like to relax and enjoy the comforts of a fully furnished historical New England estate, you can't help but be put off by the shady aura surrounding the family that used to live here. The last of the line, you remind yourself, recently committed suicide after killing his wife and two daughters with a shotgun. Involuntarily you shiver, glancing nervously at the doorways to the south and west.

Michael is curled up in bed, sound asleep.

>[3] sleep
Something is nagging at you, preventing you from sleeping... suddenly you remember -- you've left the front door unlocked.

>[4] s

Upstairs Landing
A narrow hallway runs east, from the top of the stairs down the length of the house. To the north, directly opposite the stairs, is the master bedroom.

>[5] d

Foyer
Although it appears spacious from the outside, the house's interior feels cramped and gloomy. The walls seem too close together; the ceiling is too high. The doorways, leading in several directions, are narrow and filled with shadows, and the stairs leading up to the second floor are steep and rickety. This is not a house that makes you feel welcome. It is a house that makes you feel tiny and timid, and afraid of dark places. It is a house that makes you feel alone.

The front door stands open to the south.

Your luggage is still here, spread out all over the foyer.

>[6] close door
You close the front door.

>[7] lock it
You lock the front door.

>[8] u

Upstairs Landing
A narrow hallway runs east, from the top of the stairs down the length of the house. To the north, directly opposite the stairs, is the master bedroom.

>[9] n

Master Bedroom
The master bedroom is a picture-postcard of rustic New England charm. Faded sketches of rural landscapes adorn the walls; a beautifully carved dressing mirror stands in one corner; an old-fashioned accordion radiator gurgles quietly beneath the window. The most striking feature, an enormous, antique, four-poster bed, must be the largest piece of furniture in the house.

Michael is curled up in bed, sound asleep.

>undress
That's not a verb I recognise.

>drop all
cellar key: Dropped.
house key: Dropped.

>get in bed
You can't see any such thing.

>x sketches
You can't see any such thing.

* * *

>d
Foyer
Although it appears spacious from the outside, the house's interior feels cramped and gloomy. The walls seem too close together; the ceiling is too high. The doorways, leading in several directions, are narrow and filled with shadows, and the stairs leading up to the second floor are steep and rickety. This is not a house that makes you feel welcome. It is a house that makes you feel tiny and timid, and afraid of dark places. It is a house that makes you feel alone.

Your luggage is still here, spread out all over the foyer.

>e
Sitting Room
The east wall is occupied by a beautiful antique sofa, and a large, hand-woven rug covers the hardwood floor. The huge marble fireplace in the north wall helps complete the impression of comfort and warmth, and for a moment or two you can almost think of this place as somewhere you could live, as opposed to merely somewhere others have died. The foyer lies west, and a doorway to the left of the fireplace leads north.

Your brief sense of comfort quickly drains away, however, as you become aware of the icy and maniacal stare emanating from the great portrait hanging over the mantelpiece. Under the malefic gaze of those red-rimmed eyes, the most comforting thought you can muster is that of immediate flight.

On the sofa is a family album.

>consult album about wilhelm
Wilhelm Verlac: Fled with mother Eustacia Verlac during the Witch Burnings of 1653; returned to Anchorhead in 1663; elected mayor of Anchorhead in 1690; built the Miskaton River Mill in 1695; began construction of the lighthouse in 1706.

The picture is a reproduction of a charcoal sketch, probably done when he was a younger man. The similarities to the portrait in the sitting room is evident, though: the patrician nose; the harsh, thin line of the mouth; the lean, wolfish jaw. It is the eyes, however, that carry the true family resemblance. Even in the rough, colorless strokes of charcoal, you can see that they are edged with the same raw madness that haunts the red-tinged gaze of the sitting room portrait.

>consult album about sparky
You cannot find that name anywhere in the album.

* * *

>d
Foyer
Although it appears spacious from the outside, the house's interior feels cramped and gloomy. The walls seem too close together; the ceiling is too high. The doorways, leading in several directions, are narrow and filled with shadows, and the stairs leading up to the second floor are steep and rickety. This is not a house that makes you feel welcome. It is a house that makes you feel tiny and timid, and afraid of dark places. It is a house that makes you feel alone.

Your luggage is still here, spread out all over the foyer.

>w
Dining Room
Much of the elegance has faded from this room. The huge dining table running the length of it is covered with a thick gray film of dust, and the china cupboard standing against the far wall is draped in shadow. Doorways to the north and east offer little relief from the gloom. For what must be the hundredth time, you wish you could open the windows in this place.

It's a free-standing cabinet about as tall as you are, crafted of cherrywood. The double paneled doors are closed.

>open cupboard
The cupboard is empty; the china must have been auctioned off, in the confusion before Michael was contacted, perhaps. Down at the bottom of the cupboard is a velvet lining, where the silverware would usually be kept.

>x velvet
The lining is soft, dusky burgundy. One corner in back is pulled up a bit and slightly torn.

* * *

>x journal
It's a slim little book, no bigger than your hand, bound in imitation leather. The mice really have been at it; most of the pages have been chewed away.

>read it
It's a slim little book, no bigger than your hand, bound in imitation leather. The mice really have been at it; most of the pages have been chewed away. What's left of the journal reads:

Desperate. Went back to the old twisting lane and found only a blank wall. Without the amulet, how can I resist --

...bottles, bottles...

Getting worse. People I have never met smile knowingly at me in the street. The police believe I am a child molester, but have brought no charges against me as yet. Why? Head hurts all the time. I have turned the cellar upside-down... damn it all, where is it?

Dreamed of Father again. Dreamed of Grandfather. Those horrible, red-rimmed eyes...

 -- into the safe, finally. 6-37-42. Won't forget THAT soon. Ha!

CANNOT DISCOVER ENTRANCE IN THE CELLAR!!! Secret eludes me still but I WILL FIND IT!!! The clue is in their names, that pestilential procession of names! If I could only -- 

The text breaks off as several more pages are missing. the last fragmented entry reads:

 -- will fail. There is no recourse left. I know now what I must do. Julia --

* * *

>z
Time passes.

>e
(first opening the mahogany doors)
Michael is in the study, typing furiously at his laptop. As you walk in he looks up at you with a pained expression. "Can it wait?" he asks you. "I think I'm onto something really good here, and if I don't get it all out I'm going to lose it. If you don't mind, hon, I could really use the next hour or so to myself."

Not wanting to disturb him, you tiptoe out, shutting the doors quietly behind you.

>drop all
What do you want to drop those things in?

>i
You are carrying:
  your clothes (being worn)
  your trenchcoat (being worn)
  your wedding ring (being worn)

>drop all
What do you want to drop those things in?

>drop clothes
(first taking the clothes off)
You've never been big on that "natural" look. If you decide you need to take a bath or go to bed, you can disrobe then; otherwise, keep "em on.

>s
Upstairs Hall
The shuttered window at the end of the hall throws a gloomy rectangle of light onto the bare wooden floor. Doorways lead north and south.

There is a cord dangling in mid-air here, right about level with your face.

I beg your pardon?

>n
Library
Whatever else their faults may have been, the Verlacs were evidently not ones to shun the printed word. Books line the walls from floor to ceiling in this dark-paneled, green-carpeted room, interrupted only by doorways to the east and south. A rich, brown leather armchair sits in stately repose near the window, with a polished brass pipe stand nearby completing the picture of some blue-blooded country squire's literary refuge. Once again, you are struck by how easily this place could have been the perfect home.

A beautiful pair of mahogany sliding doors stand closed to the east.

Resting on the pipe stand is a sizable volume decorated with a gilded pentagram on its cover.

>s. w. n.
Upstairs Hall
The shuttered window at the end of the hall throws a gloomy rectangle of light onto the bare wooden floor. Doorways lead north and south.

There is a cord dangling in mid-air here, right about level with your face.

Upstairs Landing
A narrow hallway runs east, from the top of the stairs down the length of the house. To the north, directly opposite the stairs, is the master bedroom.

Master Bedroom
The master bedroom is a picture-postcard of rustic New England charm. Faded sketches of rural landscapes adorn the walls; a beautifully carved dressing mirror stands in one corner; an old-fashioned accordion radiator gurgles quietly beneath the window. The most striking feature, an enormous, antique, four-poster bed, must be the largest piece of furniture in the house.

You can see your keyring (empty), your umbrella, a house key and a cellar key here.

>drop clothes
(first taking the clothes off)

>drop trenchcoat
(first taking the trenchcoat off)
Dropped.

* * *

>w
Upstairs Landing
A narrow hallway runs east, from the top of the stairs down the length of the house. To the north, directly opposite the stairs, is the master bedroom.

>d
Foyer
Although it appears spacious from the outside, the house's interior feels cramped and gloomy. The walls seem too close together; the ceiling is too high. The doorways, leading in several directions, are narrow and filled with shadows, and the stairs leading up to the second floor are steep and rickety. This is not a house that makes you feel welcome. It is a house that makes you feel tiny and timid, and afraid of dark places. It is a house that makes you feel alone.

Your luggage is still here, spread out all over the foyer.

* * *

>n
Gallery
A long, oak-paneled room, with doorways to the south and west. Paintings line the walls, mounted beneath small, shaded lamps that would illuminate the canvasses nicely if only the electricity were working. Still, even in the shadowed gloom you can see that all were done by the same artist.

>x paintings
You see nothing special about the paintings.

* * *

>save
Ok.

>stand
You get off the bed.

Master Bedroom
The master bedroom is a picture-postcard of rustic New England charm. Faded sketches of rural landscapes adorn the walls; a beautifully carved dressing mirror stands in one corner; an old-fashioned accordion radiator gurgles quietly beneath the window. The most striking feature, an enormous, antique, four-poster bed, must be the largest piece of furniture in the house.

On the four-poster bed you can see Michael's pants.

You can also see your keyring (empty), your umbrella, a house key and a cellar key here.

>i
You are carrying:
  your clothes (being worn)
  your trenchcoat (being worn)
  your wedding ring (being worn)

>s
Upstairs Landing
A narrow hallway runs east, from the top of the stairs down the length of the house. To the north, directly opposite the stairs, is the master bedroom.

* * *

>w
Upstairs Landing
A narrow hallway runs east, from the top of the stairs down the length of the house. To the north, directly opposite the stairs, is the master bedroom.

>n
Master Bedroom
The master bedroom is a picture-postcard of rustic New England charm. Faded sketches of rural landscapes adorn the walls; a beautifully carved dressing mirror stands in one corner; an old-fashioned accordion radiator gurgles quietly beneath the window. The most striking feature, an enormous, antique, four-poster bed, must be the largest piece of furniture in the house.

On the four-poster bed you can see Michael's pants.

You can also see your keyring (empty), your umbrella, a house key and a cellar key here.

>w
The bathroom is occupied at the moment.

>listen
You've never known anyone who loves a morning shower more than your husband. To him it's better than coffee. You can hear him from all the way out here, belting out "I'm Deranged" in his best David Bowie croon.

>listen
You've never known anyone who loves a morning shower more than your husband. To him it's better than coffee. You can hear him from all the way out here, belting out a spirited, one-man rendition of Beethoven's "Ode to Joy".

>listen
You've never known anyone who loves a morning shower more than your husband. To him it's better than coffee. You can hear him from all the way out here, practicing his Christopher Walken routine. "Do you know who I am? I am the Antichrist!"
.

* * *

>stand
You get off the bed.

Master Bedroom
The master bedroom is a picture-postcard of rustic New England charm. Faded sketches of rural landscapes adorn the walls; a beautifully carved dressing mirror stands in one corner; an old-fashioned accordion radiator gurgles quietly beneath the window. The most striking feature, an enormous, antique, four-poster bed, must be the largest piece of furniture in the house.

On the four-poster bed you can see Michael's pants.

You can also see your trenchcoat, your clothes, your keyring (empty), your umbrella, a house key and a cellar key here.

>drop all
What do you want to drop those things in?

>drop clothes
(first taking the clothes off)
Dropped.

>drop trenchcoat
(first taking the trenchcoat off)
Dropped.

>i
You are carrying:
  your wedding ring (being worn)

>get in bed
Gratefully, you remove your clothes, leave your things on the bedroom floor, crawl into bed and pull the covers up to your chin.

* * *

>stand
You get off the bed.

Master Bedroom
The master bedroom is a picture-postcard of rustic New England charm. Faded sketches of rural landscapes adorn the walls; a beautifully carved dressing mirror stands in one corner; an old-fashioned accordion radiator gurgles quietly beneath the window. The most striking feature, an enormous, antique, four-poster bed, must be the largest piece of furniture in the house.

On the four-poster bed you can see Michael's pants.

You can also see your trenchcoat, your clothes, your keyring (empty), your umbrella, a house key and a cellar key here.

>ress
That's not a verb I recognise.

>take all
Michael's pants: You take Michael's pants. They're the same plain khakis he usually wears..
keyring: You take the keyring. .
umbrella: You take the umbrella. It's olive green, with a hook-shaped handle. A handy little thing, when it rains. It's currently closed..
house key: You take the house key. .
cellar key: You take the cellar key. .
Michael's wallet: You take Michael's wallet. .
Michael's faculty card: The shower suddenly stops. Quickly you palm the card, replace the wallet and arrange the pants the way you found them. A moment later Michael emerges from the bathroom, toweling his hair. "My, don't you look tempting this morning," he says, giving you a kiss. He tosses the towel back into the bathroom and gets dressed. "I think I'm going to stay home and get some writing done. I don't actually start work until tomorrow, so..." He kisses you on the cheek as he walks out into the hall. "If you go out today, see if you can find a newspaper. I want to learn as much as I can about this town."

He looks at you for a moment, and his voice becomes serious. "I love you, hon. You know that, don't you? I really want us to try and be happy here."

Then he turns and pads down the hall.

You take a deep breath as he goes. You've never lied to Michael or hidden anything from him before, ever; now, hardly two days into your new life, you're already sneaking through his wallet.

Oh yeah. You're off to a great start.

>restore
Restore failed.

* * *

>stand
You get off the bed.

Master Bedroom
The master bedroom is a picture-postcard of rustic New England charm. Faded sketches of rural landscapes adorn the walls; a beautifully carved dressing mirror stands in one corner; an old-fashioned accordion radiator gurgles quietly beneath the window. The most striking feature, an enormous, antique, four-poster bed, must be the largest piece of furniture in the house.

On the four-poster bed you can see Michael's pants.

You can also see your keyring (empty), your umbrella, a house key and a cellar key here.

>ake clothes and keyring and umbrella and cellar key
That's not a verb I recognise.

>ake clothes and keyring and umbrella and cellar keyt
That's not a verb I recognise.

>ake clothes and keyring and umbrella and cellar keyt
That's not a verb I recognise.

>take clothes and keyring and cellar key
clothes: You already have that.
keyring: You take the keyring. .
cellar key: You take the cellar key. .

>i
You are carrying:
  a cellar key
  your keyring
  your clothes (being worn)
  your trenchcoat (being worn)
  your wedding ring (being worn)

>l
Master Bedroom
The master bedroom is a picture-postcard of rustic New England charm. Faded sketches of rural landscapes adorn the walls; a beautifully carved dressing mirror stands in one corner; an old-fashioned accordion radiator gurgles quietly beneath the window. The most striking feature, an enormous, antique, four-poster bed, must be the largest piece of furniture in the house.

On the four-poster bed you can see Michael's pants.

You can also see your umbrella and a house key here.

>take house key
You take the house key. .

>l
Master Bedroom
The master bedroom is a picture-postcard of rustic New England charm. Faded sketches of rural landscapes adorn the walls; a beautifully carved dressing mirror stands in one corner; an old-fashioned accordion radiator gurgles quietly beneath the window. The most striking feature, an enormous, antique, four-poster bed, must be the largest piece of furniture in the house.

On the four-poster bed you can see Michael's pants.

You can also see your umbrella here.

>s
Upstairs Landing
A narrow hallway runs east, from the top of the stairs down the length of the house. To the north, directly opposite the stairs, is the master bedroom.

* * *

>w
Upstairs Landing
A narrow hallway runs east, from the top of the stairs down the length of the house. To the north, directly opposite the stairs, is the master bedroom.

>n
Master Bedroom
The master bedroom is a picture-postcard of rustic New England charm. Faded sketches of rural landscapes adorn the walls; a beautifully carved dressing mirror stands in one corner; an old-fashioned accordion radiator gurgles quietly beneath the window. The most striking feature, an enormous, antique, four-poster bed, must be the largest piece of furniture in the house.

On the four-poster bed you can see Michael's pants.

You can also see your umbrella here.

>w
The bathroom is occupied at the moment.

>listen
You've never known anyone who loves a morning shower more than your husband. To him it's better than coffee. You can hear him from all the way out here, belting out "I'm Deranged" in his best David Bowie croon.

You hear nothing unexpected.

>listen
You've never known anyone who loves a morning shower more than your husband. To him it's better than coffee. You can hear him from all the way out here, belting out a spirited, one-man rendition of Beethoven's "Ode to Joy".

You hear nothing unexpected.

* * *

>stand
You get off the bed.

Master Bedroom
The master bedroom is a picture-postcard of rustic New England charm. Faded sketches of rural landscapes adorn the walls; a beautifully carved dressing mirror stands in one corner; an old-fashioned accordion radiator gurgles quietly beneath the window. The most striking feature, an enormous, antique, four-poster bed, must be the largest piece of furniture in the house.

On the four-poster bed you can see Michael's pants.

You can also see your trenchcoat, your clothes, your keyring (empty), your umbrella, a house key and a cellar key here.

>s
Shouldn't you dress first?

>take clothes
You put on the clothes.

>s
Upstairs Landing
A narrow hallway runs east, from the top of the stairs down the length of the house. To the north, directly opposite the stairs, is the master bedroom.

>i
You are carrying:
  your clothes (being worn)
  your wedding ring (being worn)

* * *

>stand
You get off the bed.

Master Bedroom
The master bedroom is a picture-postcard of rustic New England charm. Faded sketches of rural landscapes adorn the walls; a beautifully carved dressing mirror stands in one corner; an old-fashioned accordion radiator gurgles quietly beneath the window. The most striking feature, an enormous, antique, four-poster bed, must be the largest piece of furniture in the house.

On the four-poster bed you can see Michael's pants.

You can also see your trenchcoat, your clothes, your keyring (empty), your umbrella, a house key and a cellar key here.

>take all
Michael's pants: You take Michael's pants. They're the same plain khakis he usually wears..
trenchcoat: You put on the trenchcoat.
clothes: You put on the clothes.
keyring: You take the keyring. .
umbrella: You take the umbrella. It's olive green, with a hook-shaped handle. A handy little thing, when it rains. It's currently closed..
house key: You take the house key. .
cellar key: You take the cellar key. .
Michael's wallet: You take Michael's wallet. .
Michael's faculty card: You take Michael's faculty card. The card identifies your husband as a faculty member at Miskaton University, entitled to all the privileges that implies..

The shower suddenly stops. Quickly you palm the card, replace the wallet and arrange the pants the way you found them. A moment later Michael emerges from the bathroom, toweling his hair. "My, don't you look tempting this morning," he says, giving you a kiss. He tosses the towel back into the bathroom and gets dressed. "I think I'm going to stay home and get some writing done. I don't actually start work until tomorrow, so..." He kisses you on the cheek as he walks out into the hall. "If you go out today, see if you can find a newspaper. I want to learn as much as I can about this town."

He looks at you for a moment, and his voice becomes serious. "I love you, hon. You know that, don't you? I really want us to try and be happy here."

Then he turns and pads down the hall.

You take a deep breath as he goes. You've never lied to Michael or hidden anything from him before, ever; now, hardly two days into your new life, you're already sneaking through his wallet.

Oh yeah. You're off to a great start.

>restore
Restore failed.

* * *

>stand
You get off the bed.

Master Bedroom
The master bedroom is a picture-postcard of rustic New England charm. Faded sketches of rural landscapes adorn the walls; a beautifully carved dressing mirror stands in one corner; an old-fashioned accordion radiator gurgles quietly beneath the window. The most striking feature, an enormous, antique, four-poster bed, must be the largest piece of furniture in the house.

On the four-poster bed you can see Michael's pants.

You can also see your trenchcoat, your clothes, your keyring (empty), your umbrella, a house key and a cellar key here.

>take card
You take Michael's faculty card. The card identifies your husband as a faculty member at Miskaton University, entitled to all the privileges that implies..

The shower suddenly stops. Quickly you palm the card, replace the wallet and arrange the pants the way you found them. A moment later Michael emerges from the bathroom, toweling his hair. "My, don't you look tempting this morning," he says, giving you a kiss. He tosses the towel back into the bathroom and gets dressed. "I think I'm going to stay home and get some writing done. I don't actually start work until tomorrow, so..." He kisses you on the cheek as he walks out into the hall. "If you go out today, see if you can find a newspaper. I want to learn as much as I can about this town."

He looks at you for a moment, and his voice becomes serious. "I love you, hon. You know that, don't you? I really want us to try and be happy here."

Then he turns and pads down the hall.

You take a deep breath as he goes. You've never lied to Michael or hidden anything from him before, ever; now, hardly two days into your new life, you're already sneaking through his wallet.

Oh yeah. You're off to a great start.

* * *

>s
Upstairs Landing
A narrow hallway runs east, from the top of the stairs down the length of the house. To the north, directly opposite the stairs, is the master bedroom.

* * *

>d
Foyer
Although it appears spacious from the outside, the house's interior feels cramped and gloomy. The walls seem too close together; the ceiling is too high. The doorways, leading in several directions, are narrow and filled with shadows, and the stairs leading up to the second floor are steep and rickety. This is not a house that makes you feel welcome. It is a house that makes you feel tiny and timid, and afraid of dark places. It is a house that makes you feel alone.

Your luggage is still here, spread out all over the foyer.

>unlock door
You unlock the front door.

>open door
You open the front door.

>s
Outside the House
The lane runs up from the southeast and ends at a wide clearing surrounded by gnarled and ancient trees. A wide, curving driveway runs up to the front door of your house, which lies north.

The Verlac mansion looms before you, casting an air of menace ove the clearing.

A typewritten notice has been attached to the front door.

>se
Scenic View
The treeline falls away on the north side of this northwest-northeast bend in the road, giving way to a panoramic view of the Miskaton River Valley and the grubby little town of Anchorhead nestled within it. From here you can see the paper mill almost directly to the north; the solitary lighthouse and surrounding ocean to the northeast; and the dilapidated stone church below you to the east. Winding through it all is the oily black ribbon of the Miskaton, and almost directly in the center lies the little clearing of Town Square. You can just make out the shape of the obelisk from here.

>ne
Chilly Avenue
Perhaps it is merely the effect of some unwholesome vapour rising from the murky waters of the nearby Miskaton, but the temperature along this street seems perceptibly cooler than normal, even for a New England autumn. Two dirt roads lead south and southwest, into the dense woods at the edge of town.

>n
Riverwalk
A low, irregular brick wall to the north divides this street from the steep, mud-slick banks of the sinuous Miskaton, while a rusty iron gate provides access to a precarious flight of stone steps leading down the bank to the water's edge. The street bends south here, turning into a misty avenue between the trees. The town square lies west, a vacant lot lies east.

* * *

>stand
You get off the bed.

Master Bedroom
The master bedroom is a picture-postcard of rustic New England charm. Faded sketches of rural landscapes adorn the walls; a beautifully carved dressing mirror stands in one corner; an old-fashioned accordion radiator gurgles quietly beneath the window. The most striking feature, an enormous, antique, four-poster bed, must be the largest piece of furniture in the house.

On the four-poster bed you can see Michael's pants.

You can also see your trenchcoat, your clothes, your keyring (empty), your umbrella, a house key and a cellar key here.

>take pants
You take Michael's pants. They're the same plain khakis he usually wears..

>drop pants
Dropped.

>x pants
They're the same plain khakis he usually wears. You notice something in the back pocket.

In Michael's pants is Michael's wallet.

>take wallet
You take Michael's wallet. It's just his wallet, an ordinary leather wallet..

>drop it
Dropped.

>x wallet
It's just his wallet, an ordinary leather wallet.

In Michael's wallet is Michael's faculty card.

>take card
You take Michael's faculty card. The card identifies your husband as a faculty member at Miskaton University, entitled to all the privileges that implies..

The shower suddenly stops. Quickly you palm the card, replace the wallet and arrange the pants the way you found them. A moment later Michael emerges from the bathroom, toweling his hair. "My, don't you look tempting this morning," he says, giving you a kiss. He tosses the towel back into the bathroom and gets dressed. "I think I'm going to stay home and get some writing done. I don't actually start work until tomorrow, so..." He kisses you on the cheek as he walks out into the hall. "If you go out today, see if you can find a newspaper. I want to learn as much as I can about this town."

He looks at you for a moment, and his voice becomes serious. "I love you, hon. You know that, don't you? I really want us to try and be happy here."

Then he turns and pads down the hall.

You take a deep breath as he goes. You've never lied to Michael or hidden anything from him before, ever; now, hardly two days into your new life, you're already sneaking through his wallet.

Oh yeah. You're off to a great start.

* * *

>take pants
You take Michael's pants. They're the same plain khakis he usually wears.  .

>x it
Thick, goose-down mattress, linen sheets, feather pillows, gauze canopy -- it's about the most beautiful, inviting bed you've ever seen.

* * *

>restart
Are you sure you want to restart?

>yes
Informhead
An Interactive Fiction by Ed Peters
Release 1 / Serial number 230523 / Inform 7 v10.1.2 / D

Outside the Real Estate Office
A grim little cul-de-sac, tucked away in a corner of the claustrophobic tangle of narrow, twisting avenues that largely constitute the older portion of Anchorhead. Like most of the streets in this city, it is ancient, shadowy, and leads essentially nowhere. The lane ends here at the real estate agent's office, which lies to the east, and winds its way back toward the center of town to the west. A narrow, garbage-choked alley opens to the southeast.

* * *

>take light
Taken.

* * *

>turn it on
You switch the flashlight on.

>nw
Pantry
The pantry is empty save for a layer of dust on the shelves. A door to the south leads down to the cellar, or you can return to the kitchen to the southeast.

Leaning in the corner is an old broom.

>x door
You can't see any such thing.

>x cdoor
You see nothing special about the cdoor.

>unlock cdoor
Maybe you need a key for that?

>unlock cdoor with cellar key
You unlock the cdoor.

>d
(first opening the cdoor)

Cellar
The old, flagstone walls gleam with unwholesome-smelling moisture, and the sagging timbers creak uneasily above your head. Ancient, frayed wiring festoons the ceiling like some strange species of clinging vine. Portions of the cellar extend south and east into the clammy darkness, though you could always beat a hasty retreat up the stairs to the north.

One largish bundle of wires leads down to a rusty old fuse cabinet bolted to the far wall.

>x wiring
The wiring runs back and forth across the ceiling in every direction -- wrapped around timbers, in and out of rusted, broken conduits, crossing and re-crossing itself in a dozen places. You can see several places where the insulation is cracked or stripped altogether. It's enough to send any self-respecting fire marshall into conniptions.

>x timbers
The ancient, worm-eaten beams are bent like bows under the strain of holding up the huge, rambling house above them for centuries on end. Every few minutes, one of them gives out an ominous groan as the weight on them settles.

>open cabinet
It isn't something you can open.

* * *

>x pants
They're the same plain khakis he usually wears. You notice something in the back pocket.

In Michael's pants is Michael's wallet.

>look in pants
In Michael's pants is Michael's wallet.

>x wallet
It's just his wallet, an ordinary leather wallet.

>look in wallet
In Michael's wallet is Michael's faculty card.

* * *

>take wallet
You take Michael's wallet. It's just his wallet, an ordinary leather wallet..

>x it
It's just his wallet, an ordinary leather wallet.

>take card
You can't see any such thing.

>search wallet
In Michael's wallet is Michael's faculty card.

>take card
You take Michael's faculty card. The card identifies your husband as a faculty member at Miskaton University, entitled to all the privileges that implies..

The shower suddenly stops. Quickly you palm the card, replace the wallet and arrange the pants the way you found them. A moment later Michael emerges from the bathroom, toweling his hair. "My, don't you look tempting this morning," he says, giving you a kiss. He tosses the towel back into the bathroom and gets dressed. "I think I'm going to stay home and get some writing done. I don't actually start work until tomorrow, so..." He kisses you on the cheek as he walks out into the hall. "If you go out today, see if you can find a newspaper. I want to learn as much as I can about this town."

He looks at you for a moment, and his voice becomes serious. "I love you, hon. You know that, don't you? I really want us to try and be happy here."

Then he turns and pads down the hall.

You take a deep breath as he goes. You've never lied to Michael or hidden anything from him before, ever; now, hardly two days into your new life, you're already sneaking through his wallet.

Oh yeah. You're off to a great start.

* * *

>restart
Are you sure you want to restart?

>yes
The oldest and strongest emotion of mankind
is fear, and the oldest and strongest kind of
fear is fear of the unknown.

-- H.P. Lovecraft
                                                                                                                                                                                                                                                                                                                  I N F O R M H E A D

Please press SPACE to continue.

* * *

The oldest and strongest emotion of mankind
is fear, and the oldest and strongest kind of
fear is fear of the unknown.

-- H.P. Lovecraft
                                                                                                                                                                                                                                                  I N F O R M H E A D

Please press SPACE to continue.

>test day2
>--> The following tests are available:
'test mreads'
'test mfollows'
'test msleeps'
'test day1'
'test betray'
'test window'
'test fence'
'test machine'
'test cabinet'
'test cup'
'test door'
'test streets'
'test lantern'
'test flask'
'test pubdeets'
'test library'
'test register'
'test bell'
'test fetchem'
'test hatch'
'test spur'
'test mattress'
'test tin'
'test nastymist'
'test goodmist'
'test notice'
'test crypt'
'test study'
'test locket'
'test pages'
'test safe'
'test sitting'
'test gallery'
'test dining'
'test kitchen'

* * *

>take album
You take the album. It's a slim, hardbound volume in dark leather, unadorned except for name "Verlac" embossed on the front. Glancing at the title page, you notice two details: one, the book was self-published; andtwo, it was published in 1944. So it's a good bet that Edward Verlac and his family aren't mentionedhere..

>read it
It's a slim, hardbound volume in dark leather, unadorned except for name "Verlac" embossed on the front. Glancing at the title page, you notice two details: one, the book was self-published; andtwo, it was published in 1944. So it's a good bet that Edward Verlac and his family aren't mentionedhere.

>consult album about edward
Since this book was only published in 1944, there is no mention of Edward Verlac or his family. He probably wasn't even born yet.

>consult album about sparky
Foo.

>consult album about wilhelm
Wilhelm Verlac: Fled with mother Eustacia Verlac during the Witch Burnings of 1653; returned to Anchorhead in 1663; elected mayor of Anchorhead in 1690; built the Miskaton River Mill in 1695; began construction of the lighthouse in 1706.

The picture is a reproduction of a charcoal sketch, probably done when he was a younger man. The similarities to the portrait in the sitting room is evident, though: the patrician nose; the harsh, thin line of the mouth; the lean, wolfish jaw. It is the eyes, however, that carry the true family resemblance. Even in the rough, colorless strokes of charcoal, you can see that they are edged with the same raw madness that haunts the red-tinged gaze of the sitting room portrait.

* * *

>s. d. e. n.
(first getting off the bed)

Upstairs Landing
A narrow hallway runs east, from the top of the stairs down the length of the house. To the north, directly opposite the stairs, is the master bedroom.

Foyer
Although it appears spacious from the outside, the house's interior feels cramped and gloomy. The walls seem too close together; the ceiling is too high. The doorways, leading in several directions, are narrow and filled with shadows, and the stairs leading up to the second floor are steep and rickety. This is not a house that makes you feel welcome. It is a house that makes you feel tiny and timid, and afraid of dark places. It is a house that makes you feel alone.

Your luggage is still here, spread out all over the foyer.

Sitting Room
The east wall is occupied by a beautiful antique sofa, and a large, hand-woven rug covers the hardwood floor. The huge marble fireplace in the north wall helps complete the impression of comfort and warmth, and for a moment or two you can almost think of this place as somewhere you could live, as opposed to merely somewhere others have died. The foyer lies west, and a doorway to the left of the fireplace leads north.

Your brief sense of comfort quickly drains away, however, as you become aware of the icy and maniacal stare emanating from the great portrait hanging over the mantelpiece. Under the malefic gaze of those red-rimmed eyes, the most comforting thought you can muster is that of immediate flight.

On the sofa is a family album.

Gallery
A long, oak-paneled room, with doorways to the south and west. Paintings line the walls, mounted beneath small, shaded lamps that would illuminate the canvasses nicely if only the electricity were working. Still, even in the shadowed gloom you can see that all were done by the same artist.

>x paintings
All of them are bizarre, and most of them border on the grotesque. Alien landscapes peopled by writhing, malformed creatures; ancient temples built in strange, eye-bending architectures; monstrous beasts crawling through shadows that cannot quite conceal their disturbingly human shapes -- these seem to make up the bulk of the paintings" subject matter. And yet, despite the fantastical nature of the images painted, the style is neither abstract nor surreal. In fact, the level of detail approaches the photorealistic. Excruciating attention has been paid to light, shadows, and textures; even the alien creatures are depicted with gruesome anatomical accuracy. It is as though the artist had worked from actual, living models rather than from what must have been a thoroughly deranged imagination, and the overall effect is rather chilling

One scene in particular catches your eye.

>x paintings
A group of primitive tribesmen dance within a ring of standing stones, beneath a lightning-streaked sky. Their dress and some of the fetishes they carry -- feathers, rattles, ceremonial masks -- all seem to represent a Native American culture, but the men themselves are... strange. They look truly savage and degenerate, in a way that you don't often see Native Americans depicted. Peering closely, you can see that some of them even appear to be deformed.

Overlooking the dance stands a tall obelisk on a hill, silhouetted against the storm clouds above. The artist added a strange effect to the cloud formations directly above the obelisk; the color and shading seem to suggest a red, baleful eye looking down upon the strange ritual below.

You shake yourself suddenly, and realize you've been staring intently at the painting for minutes on end. You step back and rub your tired eyes. When you look again, however, the picture you were just examining is no longer in front of you. None of the other paintings have moved as far as you can tell, but that particular scene seems to have disappeared without leaving so much as a blank space on the wall.

>x paintings
You search the paintings thoroughly, but cannot find the scene you saw earlier.

>x paintings
You search the paintings thoroughly, but cannot find the scene you saw earlier.

>s
Sitting Room
The east wall is occupied by a beautiful antique sofa, and a large, hand-woven rug covers the hardwood floor. The huge marble fireplace in the north wall helps complete the impression of comfort and warmth, and for a moment or two you can almost think of this place as somewhere you could live, as opposed to merely somewhere others have died. The foyer lies west, and a doorway to the left of the fireplace leads north.

The portrait gazes down at you with crimson-edged malice.

On the sofa is a family album.

>n
Gallery
A long, oak-paneled room, with doorways to the south and west. Paintings line the walls, mounted beneath small, shaded lamps that would illuminate the canvasses nicely if only the electricity were working. Still, even in the shadowed gloom you can see that all were done by the same artist.

>x paintings
All of them are bizarre, and most of them border on the grotesque. Alien landscapes peopled by writhing, malformed creatures; ancient temples built in strange, eye-bending architectures; monstrous beasts crawling through shadows that cannot quite conceal their disturbingly human shapes -- these seem to make up the bulk of the paintings" subject matter. And yet, despite the fantastical nature of the images painted, the style is neither abstract nor surreal. In fact, the level of detail approaches the photorealistic. Excruciating attention has been paid to light, shadows, and textures; even the alien creatures are depicted with gruesome anatomical accuracy. It is as though the artist had worked from actual, living models rather than from what must have been a thoroughly deranged imagination, and the overall effect is rather chilling

One scene in particular catches your eye.

>x paintings
The scene depicts a young girl kneeling down next to a closed door, whispering through the keyhole. It is evidently late at night, as the girl is wearing her nightgown, and she is surrounded by shadows. The room on the other side of the door is lit, and the light shining through the keyhole and through the crack under the door casts an eldritch, yellow glow across her face. The girl appears to be furtively slipping something underneath the door; you can't see what, exactly.

It's a fairly innocent-looking scene; charming, even, in a way... that is, until you notice the mottled appendage snaking out from underneath the door to meet her hand. From her expression, the girl is either unaware of it or unperturbed by it. Either way, the effect is deeply disturbing.

You shake yourself suddenly, and realize you've been staring intently at the painting for minutes on end. You step back and rub your tired eyes. When you look again, however, the picture you were just examining is no longer in front of you. None of the other paintings have moved as far as you can tell, but that particular scene seems to have disappeared without leaving so much as a blank space on the wall.

>x paintings
You search the paintings thoroughly, but cannot find the scene you saw earlier.

>read paintings
You search the paintings thoroughly, but cannot find the scene you saw earlier.

>i
You are carrying:
  your clothes (being worn)
  your trenchcoat (being worn)
  your wedding ring (being worn)

>read clothes
A tasteful ensemble from Ann Taylor in muted browns and olive greens (you've been an autumn person since you were old enough to match your own socks).

>w
Back Hall
A short hallway, connecting rooms to the east, west and south.

* * *

>s
(first opening the front door)
(first unlocking the front door)

>s
(first opening the front door)
(first unlocking the front door)

* * *

>i
You are carrying:
  a house key
  your clothes (being worn)
  your trenchcoat (being worn)
  your wedding ring (being worn)
  your umbrella
  your keyring
    a cellar key

* * *

>nw
You may leave to the east, or approach the counter to the north.

* * *

>nw
Outside the House
The lane runs up from the southeast and ends at a wide clearing surrounded by gnarled and ancient trees. A wide, curving driveway runs up to the front door of your house, which lies north.

The fabled Verlac family mansion looms before you in the gloom, its dark creaking presence dominating the clearing and, somehow, even though it is not visible through the trees, the entire valley. The foreboding shadow of the Verlacs seems to enshroud all of Anchorhead from here.

A typewritten notice has been attached to the front door.

Michael follows you.

>unlock door
You unlock the front door.

>n
(first opening the front door)

Foyer
Although it appears spacious from the outside, the house's interior feels cramped and gloomy. The walls seem too close together; the ceiling is too high. The doorways, leading in several directions, are narrow and filled with shadows, and the stairs leading up to the second floor are steep and rickety. This is not a house that makes you feel welcome. It is a house that makes you feel tiny and timid, and afraid of dark places. It is a house that makes you feel alone.

The front door stands open to the south.

Carelessly stacked in a towering heap in the middle of the room are all your luggage and belongings, which you had sent ahead through a moving company before driving up to Massachusetts. Everything you own is boxed away and piled up in the middle of the floor. The reality of this move finally slams home as you stare at the sprawling jumble of stuff, and suddenly you feel very lost and adrift.

Night has now undeniably fallen, and the house is very, very dark. There is probably just enough residual ambience to feel your way upstairs to the bedroom, but the rest of the house is a tenebrous maze of shadows, and any exploring would probably best be done in the morning.

Michael stretches his arms and yawns. "Well," he says, "I think I'm going to turn in. There'll be plenty of time to unpack and explore tomorrow. Good night, hon." He kisses you on the cheek. "Don't stay up too late."

>l
Foyer
Although it appears spacious from the outside, the house's interior feels cramped and gloomy. The walls seem too close together; the ceiling is too high. The doorways, leading in several directions, are narrow and filled with shadows, and the stairs leading up to the second floor are steep and rickety. This is not a house that makes you feel welcome. It is a house that makes you feel tiny and timid, and afraid of dark places. It is a house that makes you feel alone.

The front door stands open to the south.

Your luggage is still here, spread out all over the foyer.

>s
Outside the House
The lane runs up from the southeast and ends at a wide clearing surrounded by gnarled and ancient trees. A wide, curving driveway runs up to the front door of your house, which lies north.

The Verlac mansion looms before you, casting an air of menace ove the clearing.

A typewritten notice has been attached to the front door.

>n
Foyer
Although it appears spacious from the outside, the house's interior feels cramped and gloomy. The walls seem too close together; the ceiling is too high. The doorways, leading in several directions, are narrow and filled with shadows, and the stairs leading up to the second floor are steep and rickety. This is not a house that makes you feel welcome. It is a house that makes you feel tiny and timid, and afraid of dark places. It is a house that makes you feel alone.

The front door stands open to the south.

Your luggage is still here, spread out all over the foyer.

>u
You can't go that way.

>l
Foyer
Although it appears spacious from the outside, the house's interior feels cramped and gloomy. The walls seem too close together; the ceiling is too high. The doorways, leading in several directions, are narrow and filled with shadows, and the stairs leading up to the second floor are steep and rickety. This is not a house that makes you feel welcome. It is a house that makes you feel tiny and timid, and afraid of dark places. It is a house that makes you feel alone.

The front door stands open to the south.

Your luggage is still here, spread out all over the foyer.

>u
You can't go that way.

* * *

>restore
Restore failed.

* * *

>s
You can't go that way.

>w
Upstairs Landing
A narrow hallway runs east, from the top of the stairs down the length of the house. To the north, directly opposite the stairs, is the master bedroom.

Michael follows you.

>e
Upstairs Hall
The shuttered window at the end of the hall throws a gloomy rectangle of light onto the bare wooden floor. Doorways lead north and south.

Michael follows you.

>n
Library
Shadows roost thickly in the vaulted ceiling, and small, green-shaded desk lamps cast pools of warm radiance here and there around the library's dim interior. You pause a moment to let the hushed peacefulness of this place soak in -- a welcome relief from the unsettling events of the day. An exit lies east, and a small alcove to the north houses the circulation counter.

A beautiful pair of mahogany sliding doors stand closed to the east.

Michael follows you.

>x stand
It's a beautiful piece of work, although at the moment, sadly, it contains no pipe.

* * *

The oldest and strongest emotion of mankind
is fear, and the oldest and strongest kind of
fear is fear of the unknown.

-- H.P. Lovecraft
                                                                                                                                                                                                                                                  I N F O R M H E A D

Please press SPACE to continue.

>test foyer
>--> The following tests are available:
'test mreads'
'test mfollows'
'test msleeps'
'test day1'
'test betray'
'test window'
'test fence'
'test machine'
'test cabinet'
'test cup'
'test door'
'test streets'
'test lantern'
'test flask'
'test pubdeets'
'test library'
'test register'
'test bell'
'test fetchem'
'test hatch'
'test spur'
'test mattress'
'test tin'
'test nastymist'
'test goodmist'
'test notice'
'test study'

>test mreads
(Testing.)

>[1] se
You can't go that way.

>[2] push cans to window
You can't see any such thing.

>[3] stand on cans
You can't see any such thing.

>[4] open window
You must name something more substantial.

>[5] enter window
You must name something more substantial.

>[6] consult cabinet about verlac
You can't see any such thing.

>[7] w
You can't go that way.

>[8] unlock door
You can't see any such thing.

>[9] w
You can't go that way.

>[10] w
You can't go that way.

>[11] w
You can't go that way.

>[12] nw
You can't go that way.

>[13] w
You can't go that way.

>[14] say hello to michael
You can't see any such thing.

>[15] ask michael about verlac
You can't see any such thing.

>[16] show house key to michael
You can't see any such thing.

>restart
Are you sure you want to restart?

>yes
Informhead
An Interactive Fiction by Ed Peters
Release 1 / Serial number 230522 / Inform 7 v10.1.2 / D

Upstairs Landing
A narrow hallway runs east, from the top of the stairs down the length of the house. To the north, directly opposite the stairs, is the master bedroom.

>e
Upstairs Hall
The shuttered window at the end of the hall throws a gloomy rectangle of light onto the bare wooden floor. Doorways lead north and south.

>s
You can't go that way.

* * *

>.nw
That's not a verb I recognise.

>nw
Outside the House
The lane runs up from the southeast and ends at a wide clearing surrounded by gnarled and ancient trees. A wide, curving driveway runs up to the front door of your house, which lies north.

The fabled Verlac family mansion looms before you in the gloom, its dark creaking presence dominating the clearing and, somehow, even though it is not visible through the trees, the entire valley. The foreboding shadow of the Verlacs seems to enshroud all of Anchorhead from here.

A typewritten notice has been attached to the front door.

You can also see a front door here.

Michael follows you.

>x door
The front door is a huge, paneled slab of black oak adorned with a brass knocker in its center.

>open it
It seems to be locked.

>unlock it
You unlock the front door.

>open it
You open the front door.

>n
Foyer
Although it appears spacious from the outside, the house's interior feels cramped and gloomy. The walls seem too close together; the ceiling is too high. The doorways, leading in several directions, are narrow and filled with shadows, and the stairs leading up to the second floor are steep and rickety. This is not a house that makes you feel welcome. It is a house that makes you feel tiny and timid, and afraid of dark places. It is a house that makes you feel alone.

The front door stands open to the south.

Carelessly stacked in a towering heap in the middle of the room are all your luggage and belongings, which you had sent ahead through a moving company before driving up to Massachusetts. Everything you own is boxed away and piled up in the middle of the floor. The reality of this move finally slams home as you stare at the sprawling jumble of stuff, and suddenly you feel very lost and adrift.

Night has now undeniably fallen, and the house is very, very dark. There is probably just enough residual ambience to feel your way upstairs to the bedroom, but the rest of the house is a tenebrous maze of shadows, and any exploring would probably best be done in the morning.

Michael stretches his arms and yawns. "Well," he says, "I think I'm going to turn in. There'll be plenty of time to unpack and explore tomorrow. Good night, hon." He kisses you on the cheek. "Don't stay up too late."

You can see a front door here.

Michael follows you.

>l
Foyer
Although it appears spacious from the outside, the house's interior feels cramped and gloomy. The walls seem too close together; the ceiling is too high. The doorways, leading in several directions, are narrow and filled with shadows, and the stairs leading up to the second floor are steep and rickety. This is not a house that makes you feel welcome. It is a house that makes you feel tiny and timid, and afraid of dark places. It is a house that makes you feel alone.

The front door stands open to the south.

Carelessly stacked in a towering heap in the middle of the room are all your luggage and belongings, which you had sent ahead through a moving company before driving up to Massachusetts. Everything you own is boxed away and piled up in the middle of the floor. The reality of this move finally slams home as you stare at the sprawling jumble of stuff, and suddenly you feel very lost and adrift.

Michael is here.

You can also see a front door here.

* * *

>ne
Chilly Avenue
Perhaps it is merely the effect of some unwholesome vapour rising from the murky waters of the nearby Miskaton, but the temperature along this street seems perceptibly cooler than normal, even for a New England autumn. Two dirt roads lead south and southwest, into the dense woods at the edge of town.

Michael follows you.

>test notice
(Testing.)

>[1] sw
The ground begins to rise sharply as the road climbs up into the hills south of town.

Scenic View
The treeline falls away on the north side of this northwest-northeast bend in the road, giving way to a panoramic view of the Miskaton River Valley and the grubby little town of Anchorhead nestled within it. From here you can see the paper mill almost directly to the north; the solitary lighthouse and surrounding ocean to the northeast; and the dilapidated stone church below you to the east. Winding through it all is the oily black ribbon of the Miskaton, and almost directly in the center lies the little clearing of Town Square. You can just make out the shape of the obelisk from here.

Michael follows you.

>[2] nw

Outside the House
The lane runs up from the southeast and ends at a wide clearing surrounded by gnarled and ancient trees. A wide, curving driveway runs up to the front door of your house, which lies north.

The fabled Verlac family mansion looms before you in the gloom, its dark creaking presence dominating the clearing and, somehow, even though it is not visible through the trees, the entire valley. The foreboding shadow of the Verlacs seems to enshroud all of Anchorhead from here.

A typewritten notice has been attached to the front door.

Michael follows you.

>[3] se

Scenic View
The treeline falls away on the north side of this northwest-northeast bend in the road, giving way to a panoramic view of the Miskaton River Valley and the grubby little town of Anchorhead nestled within it. From here you can see the paper mill almost directly to the north; the solitary lighthouse and surrounding ocean to the northeast; and the dilapidated stone church below you to the east. Winding through it all is the oily black ribbon of the Miskaton, and almost directly in the center lies the little clearing of Town Square. You can just make out the shape of the obelisk from here.

Michael follows you.

>[4] nw

Outside the House
The lane runs up from the southeast and ends at a wide clearing surrounded by gnarled and ancient trees. A wide, curving driveway runs up to the front door of your house, which lies north.

The Verlac mansion looms before you, casting an air of menace ove the clearing.

A typewritten notice has been attached to the front door.

Michael follows you.

>[5] x notice
It's a letter from the Arkham Regional Utilities Company, explaining that, due to wiring difficulties, the electricity will not be installed until next week. No phone service, either.

"Well, that's wonderful news," remarks Michael dryly, reading over your shoulder.

>[6] take notice
Taken.

>[7] x it
It's a letter from the Arkham Regional Utilities Company, explaining that, due to wiring difficulties, the electricity will not be installed until next week. No phone service, either.

* * *

>nw
Outside the House
The lane runs up from the southeast and ends at a wide clearing surrounded by gnarled and ancient trees. A wide, curving driveway runs up to the front door of your house, which lies north.

The fabled Verlac family mansion looms before you in the gloom, its dark creaking presence dominating the clearing and, somehow, even though it is not visible through the trees, the entire valley. The foreboding shadow of the Verlacs seems to enshroud all of Anchorhead from here.

A typewritten notice has been attached to the front door.

Michael follows you.

>n
(first opening the front door)
It seems to be locked.

>unlock door. n.
You unlock the front door.

(first opening the front door)

Foyer
Although it appears spacious from the outside, the house's interior feels cramped and gloomy. The walls seem too close together; the ceiling is too high. The doorways, leading in several directions, are narrow and filled with shadows, and the stairs leading up to the second floor are steep and rickety. This is not a house that makes you feel welcome. It is a house that makes you feel tiny and timid, and afraid of dark places. It is a house that makes you feel alone.

The front door stands open to the south.

Carelessly stacked in a towering heap in the middle of the room are all your luggage and belongings, which you had sent ahead through a moving company before driving up to Massachusetts. Everything you own is boxed away and piled up in the middle of the floor. The reality of this move finally slams home as you stare at the sprawling jumble of stuff, and suddenly you feel very lost and adrift.

Night has now undeniably fallen, and the house is very, very dark. There is probably just enough residual ambience to feel your way upstairs to the bedroom, but the rest of the house is a tenebrous maze of shadows, and any exploring would probably best be done in the morning.

Michael stretches his arms and yawns. "Well," he says, "I think I'm going to turn in. There'll be plenty of time to unpack and explore tomorrow. Good night, hon." He kisses you on the cheek. "Don't stay up too late."

>u
Upstairs Landing
A narrow hallway runs east, from the top of the stairs down the length of the house. To the north, directly opposite the stairs, is the master bedroom.

>n
Master Bedroom
The master bedroom is a picture-postcard of rustic New England charm. Faded sketches of rural landscapes adorn the walls; a beautifully carved dressing mirror stands in one corner; an old-fashioned accordion radiator gurgles quietly beneath the window. The most striking feature, an enormous, antique, four-poster bed, must be the largest piece of furniture in the house.

If it weren't for this hopelessly backwater town and the disturbing circumstances surrounding the house, you'd say this was your dream home. Even so, as much as you would like to relax and enjoy the comforts of a fully furnished historical New England estate, you can't help but be put off by the shady aura surrounding the family that used to live here. The last of the line, you remind yourself, recently committed suicide after killing his wife and two daughters with a shotgun. Involuntarily you shiver, glancing nervously at the doorways to the south and west.

Michael is curled up in bed, sound asleep.

>l
Master Bedroom
The master bedroom is a picture-postcard of rustic New England charm. Faded sketches of rural landscapes adorn the walls; a beautifully carved dressing mirror stands in one corner; an old-fashioned accordion radiator gurgles quietly beneath the window. The most striking feature, an enormous, antique, four-poster bed, must be the largest piece of furniture in the house.

Michael is curled up in bed, sound asleep.

>s
Upstairs Landing
A narrow hallway runs east, from the top of the stairs down the length of the house. To the north, directly opposite the stairs, is the master bedroom.

>n
Master Bedroom
The master bedroom is a picture-postcard of rustic New England charm. Faded sketches of rural landscapes adorn the walls; a beautifully carved dressing mirror stands in one corner; an old-fashioned accordion radiator gurgles quietly beneath the window. The most striking feature, an enormous, antique, four-poster bed, must be the largest piece of furniture in the house.

Michael is curled up in bed, sound asleep.

>ask michael about verlac
"I'd never heard of the guy before; I didn't even know I had a 'third cousin, twice removed'," says Michael. "Kind of creepy, though, don't you think? He went crazy, you know, killed his whole family, then killed himself in his cell up at Danvers. Just terrible. Still, we got the house and I got a professorship, so you won't hear me complaining.".

>scenes
Scene 'Entire Game' playing (for 33 mins now)
Scene 'Day 1' playing (for 33 mins now)
Scene 'Michael Reads' ended
Scene 'Michael Follows' ended
Scene 'Michael Sleeps' playing (for 6 mins now)
(Scene monitoring now switched on. Type "scenes off" to switch it off again.)

>say hello to michael
Best not. He seems exhausted.

>show house key to michael
Michael is unimpressed.

* * *

>nw
Outside the House
The lane runs up from the southeast and ends at a wide clearing surrounded by gnarled and ancient trees. A wide, curving driveway runs up to the front door of your house, which lies north.

The fabled Verlac family mansion looms before you in the gloom, its dark creaking presence dominating the clearing and, somehow, even though it is not visible through the trees, the entire valley. The foreboding shadow of the Verlacs seems to enshroud all of Anchorhead from here.

A typewritten notice has been attached to the front door.

Michael follows you.

>se
Scenic View
The treeline falls away on the north side of this northwest-northeast bend in the road, giving way to a panoramic view of the Miskaton River Valley and the grubby little town of Anchorhead nestled within it. From here you can see the paper mill almost directly to the north; the solitary lighthouse and surrounding ocean to the northeast; and the dilapidated stone church below you to the east. Winding through it all is the oily black ribbon of the Miskaton, and almost directly in the center lies the little clearing of Town Square. You can just make out the shape of the obelisk from here.

Michael follows you.

>nw
Outside the House
The lane runs up from the southeast and ends at a wide clearing surrounded by gnarled and ancient trees. A wide, curving driveway runs up to the front door of your house, which lies north.

The Verlac mansion looms before you, casting an air of menace ove the clearing.

A typewritten notice has been attached to the front door.

Michael follows you.

* * *

>s
Outside the House
The lane runs up from the southeast and ends at a wide clearing surrounded by gnarled and ancient trees. A wide, curving driveway runs up to the front door of your house, which lies north.

The Verlac mansion looms before you, casting an air of menace ove the clearing.

A typewritten notice has been attached to the front door.

>n
Foyer
Although it appears spacious from the outside, the house's interior feels cramped and gloomy. The walls seem too close together; the ceiling is too high. The doorways, leading in several directions, are narrow and filled with shadows, and the stairs leading up to the second floor are steep and rickety. This is not a house that makes you feel welcome. It is a house that makes you feel tiny and timid, and afraid of dark places. It is a house that makes you feel alone.

The front door stands open to the south.

Your luggage is still here, spread out all over the foyer."

>s
Outside the House
The lane runs up from the southeast and ends at a wide clearing surrounded by gnarled and ancient trees. A wide, curving driveway runs up to the front door of your house, which lies north.

The Verlac mansion looms before you, casting an air of menace ove the clearing.

Michael is here.

A typewritten notice has been attached to the front door.

>se
Scenic View
The treeline falls away on the north side of this northwest-northeast bend in the road, giving way to a panoramic view of the Miskaton River Valley and the grubby little town of Anchorhead nestled within it. From here you can see the paper mill almost directly to the north; the solitary lighthouse and surrounding ocean to the northeast; and the dilapidated stone church below you to the east. Winding through it all is the oily black ribbon of the Miskaton, and almost directly in the center lies the little clearing of Town Square. You can just make out the shape of the obelisk from here.

>nw
Outside the House
The lane runs up from the southeast and ends at a wide clearing surrounded by gnarled and ancient trees. A wide, curving driveway runs up to the front door of your house, which lies north.

The Verlac mansion looms before you, casting an air of menace ove the clearing.

Michael is here.

A typewritten notice has been attached to the front door.

* * *

>l
Foyer
Although it appears spacious from the outside, the house's interior feels cramped and gloomy. The walls seem too close together; the ceiling is too high. The doorways, leading in several directions, are narrow and filled with shadows, and the stairs leading up to the second floor are steep and rickety. This is not a house that makes you feel welcome. It is a house that makes you feel tiny and timid, and afraid of dark places. It is a house that makes you feel alone.

The front door stands open to the south.

Your luggage is still here, spread out all over the foyer.

>x luggage
It's all a huge, hopeless mess. Just looking at it instantly drains you of any desire to unpack.

>search luggage
You find nothing of interest.

>sleep
You aren't feeling especially drowsy.

* * *

>se
You can't go that way.

>s
Outside the House
The lane runs up from the southeast and ends at a wide clearing surrounded by gnarled and ancient trees. A wide, curving driveway runs up to the front door of your house, which lies north.

The Verlac mansion looms before you, casting an air of menace ove the clearing.

Michael is here.

A typewritten notice has been attached to the front door.

* * *

>u
Upstairs Landing
A narrow hallway runs east, from the top of the stairs down the length of the house. To the north, directly opposite the stairs, is the master bedroom.

* * *

>e
Upstairs Hall
The shuttered window at the end of the hall throws a gloomy rectangle of light onto the bare wooden floor. Doorways lead north and south.

>n
House Library
Whatever else their faults may have been, the Verlacs were evidently not ones to shun the printed word. Books line the walls from floor to ceiling in this dark-paneled, green-carpeted room, interrupted only by doorways to the east and south. A rich, brown leather armchair sits in stately repose near the window, with a polished brass pipe stand nearby completing the picture of some blue-blooded country squire's literary refuge. Once again, you are struck by how easily this place could have been the perfect home.

A beautiful pair of mahogany sliding doors stand closed to the east.

Resting on the pipe stand is a sizable volume decorated with a gilded pentagram on its cover.

>x doors
Each door is carved from a single piece of mahogany, and polished to a deep, rich shine. The doors are closed.

* * *

>open doors
You open the mahogany doors.

>e
You can't, since the mahogany doors lead nowhere.

>close doors
You close the mahogany doors.

>l
House Library
Whatever else their faults may have been, the Verlacs were evidently not ones to shun the printed word. Books line the walls from floor to ceiling in this dark-paneled, green-carpeted room, interrupted only by doorways to the east and south. A rich, brown leather armchair sits in stately repose near the window, with a polished brass pipe stand nearby completing the picture of some blue-blooded country squire's literary refuge. Once again, you are struck by how easily this place could have been the perfect home.

A beautiful pair of mahogany sliding doors stand closed to the east.

Resting on the pipe stand is a sizable volume decorated with a gilded pentagram on its cover.

>x pipe stand
It's a beautiful piece of work, although at the moment, sadly, it contains no pipe.

>take tome
You can't see any such thing.

>take manual
Taken.

>x it
It's an old medieval tome dated in the early 1300s, written by one Galarian Academius desChamps.

>read it
It's an old medieval tome dated in the early 1300s, written by one Galarian Academius desChamps.

>examine it
It's an old medieval tome dated in the early 1300s, written by one Galarian Academius desChamps.

>i
You are carrying:
  a The Compleat Manual of Wardes and Seales
  a cellar key
  a house key
  your clothes (being worn)
  your trenchcoat (being worn)
  your wedding ring (being worn)
  a keyring

>x chair
It's the kind of furniture that you always drool over in catalogs, and it looks about as comfortable as an armchair ever gets without an added shot of heroin.

* * *

>nw
Outside the House
The lane runs up from the southeast and ends at a wide clearing surrounded by gnarled and ancient trees. A wide, curving driveway runs up to the front door of your house, which lies north.

The fabled Verlac family mansion looms before you in the gloom, its dark creaking presence dominating the clearing and, somehow, even though it is not visible through the trees, the entire valley. The foreboding shadow of the Verlacs seems to enshroud all of Anchorhead from here.

A typewritten notice has been attached to the front door.

Michael follows you.

>unlock door. n. u.
You unlock the front door.

(first opening the front door)

Foyer
Although it appears spacious from the outside, the house's interior feels cramped and gloomy. The walls seem too close together; the ceiling is too high. The doorways, leading in several directions, are narrow and filled with shadows, and the stairs leading up to the second floor are steep and rickety. This is not a house that makes you feel welcome. It is a house that makes you feel tiny and timid, and afraid of dark places. It is a house that makes you feel alone.

The front door stands open to the south.

Carelessly stacked in a towering heap in the middle of the room are all your luggage and belongings, which you had sent ahead through a moving company before driving up to Massachusetts. Everything you own is boxed away and piled up in the middle of the floor. The reality of this move finally slams home as you stare at the sprawling jumble of stuff, and suddenly you feel very lost and adrift.

Night has now undeniably fallen, and the house is very, very dark. There is probably just enough residual ambience to feel your way upstairs to the bedroom, but the rest of the house is a tenebrous maze of shadows, and any exploring would probably best be done in the morning.

Michael stretches his arms and yawns. "Well," he says, "I think I'm going to turn in. There'll be plenty of time to unpack and explore tomorrow. Good night, hon." He kisses you on the cheek. "Don't stay up too late."

Upstairs Landing
A narrow hallway runs east, from the top of the stairs down the length of the house. To the north, directly opposite the stairs, is the master bedroom.

>n
Master Bedroom
The master bedroom is a picture-postcard of rustic New England charm. Faded sketches of rural landscapes adorn the walls; a beautifully carved dressing mirror stands in one corner; an old-fashioned accordion radiator gurgles quietly beneath the window. The most striking feature, an enormous, antique, four-poster bed, must be the largest piece of furniture in the house.

If it weren't for this hopelessly backwater town and the disturbing circumstances surrounding the house, you'd say this was your dream home. Even so, as much as you would like to relax and enjoy the comforts of a fully furnished historical New England estate, you can't help but be put off by the shady aura surrounding the family that used to live here. The last of the line, you remind yourself, recently committed suicide after killing his wife and two daughters with a shotgun. Involuntarily you shiver, glancing nervously at the doorways to the south and west.

Michael is curled up in bed, sound asleep.

>sleep
Something is nagging at you, preventing you from sleeping... suddenly you remember -- you've left the front door unlocked.

>s. d. close door. lock it.
Upstairs Landing
A narrow hallway runs east, from the top of the stairs down the length of the house. To the north, directly opposite the stairs, is the master bedroom.

Foyer
Although it appears spacious from the outside, the house's interior feels cramped and gloomy. The walls seem too close together; the ceiling is too high. The doorways, leading in several directions, are narrow and filled with shadows, and the stairs leading up to the second floor are steep and rickety. This is not a house that makes you feel welcome. It is a house that makes you feel tiny and timid, and afraid of dark places. It is a house that makes you feel alone.

The front door stands open to the south.

Your luggage is still here, spread out all over the foyer.

You close the front door.

You lock the front door.

>u. n. sleep.
Upstairs Landing
A narrow hallway runs east, from the top of the stairs down the length of the house. To the north, directly opposite the stairs, is the master bedroom.

Master Bedroom
The master bedroom is a picture-postcard of rustic New England charm. Faded sketches of rural landscapes adorn the walls; a beautifully carved dressing mirror stands in one corner; an old-fashioned accordion radiator gurgles quietly beneath the window. The most striking feature, an enormous, antique, four-poster bed, must be the largest piece of furniture in the house.

Michael is curled up in bed, sound asleep.

 Gratefully, you remove your clothes, leave your things on the bedroom floor, crawl into bed and pull the covers up to your chin.

>showme player
There seems to be no such object anywhere in the model world.

>showme
Master Bedroom - room
    yourself - person
        cellar key
        house key
        wedding ring (worn)
    Michael - man

>showme yourself
There seems to be no such object anywhere in the model world.

* * *

>nw
Outside the House
The lane runs up from the southeast and ends at a wide clearing surrounded by gnarled and ancient trees. A wide, curving driveway runs up to the front door of your house, which lies north.

The fabled Verlac family mansion looms before you in the gloom, its dark creaking presence dominating the clearing and, somehow, even though it is not visible through the trees, the entire valley. The foreboding shadow of the Verlacs seems to enshroud all of Anchorhead from here.

A typewritten notice has been attached to the front door.

Michael follows you.

>x door
The front door is a huge, paneled slab of black oak adorned with a brass knocker in its center.

>unlock it
You unlock the front door.

>n
(first opening the front door)

Foyer
Although it appears spacious from the outside, the house's interior feels cramped and gloomy. The walls seem too close together; the ceiling is too high. The doorways, leading in several directions, are narrow and filled with shadows, and the stairs leading up to the second floor are steep and rickety. This is not a house that makes you feel welcome. It is a house that makes you feel tiny and timid, and afraid of dark places. It is a house that makes you feel alone.

The front door stands open to the south.

Carelessly stacked in a towering heap in the middle of the room are all your luggage and belongings, which you had sent ahead through a moving company before driving up to Massachusetts. Everything you own is boxed away and piled up in the middle of the floor. The reality of this move finally slams home as you stare at the sprawling jumble of stuff, and suddenly you feel very lost and adrift.

Night has now undeniably fallen, and the house is very, very dark. There is probably just enough residual ambience to feel your way upstairs to the bedroom, but the rest of the house is a tenebrous maze of shadows, and any exploring would probably best be done in the morning."

Michael stretches his arms and yawns. "Well," he says, "I think I'm going to turn in. There'll be plenty of time to unpack and explore tomorrow. Good night, hon." He kisses you on the cheek. "Don't stay up too late."

>l
Foyer
Although it appears spacious from the outside, the house's interior feels cramped and gloomy. The walls seem too close together; the ceiling is too high. The doorways, leading in several directions, are narrow and filled with shadows, and the stairs leading up to the second floor are steep and rickety. This is not a house that makes you feel welcome. It is a house that makes you feel tiny and timid, and afraid of dark places. It is a house that makes you feel alone.

The front door stands open to the south.

Your luggage is still here, spread out all over the foyer."

Michael stretches his arms and yawns. "Well," he says, "I think I'm going to turn in. There'll be plenty of time to unpack and explore tomorrow. Good night, hon." He kisses you on the cheek. "Don't stay up too late."

* * *

>nw. unlock door. n.
Outside the House
The lane runs up from the southeast and ends at a wide clearing surrounded by gnarled and ancient trees. A wide, curving driveway runs up to the front door of your house, which lies north.

The fabled Verlac family mansion looms before you in the gloom, its dark creaking presence dominating the clearing and, somehow, even though it is not visible through the trees, the entire valley. The foreboding shadow of the Verlacs seems to enshroud all of Anchorhead from here.

A typewritten notice has been attached to the front door.

Michael follows you.

You unlock the front door.

(first opening the front door)

Foyer
Although it appears spacious from the outside, the house's interior feels cramped and gloomy. The walls seem too close together; the ceiling is too high. The doorways, leading in several directions, are narrow and filled with shadows, and the stairs leading up to the second floor are steep and rickety. This is not a house that makes you feel welcome. It is a house that makes you feel tiny and timid, and afraid of dark places. It is a house that makes you feel alone.

The front door stands open to the south.

Carelessly stacked in a towering heap in the middle of the room are all your luggage and belongings, which you had sent ahead through a moving company before driving up to Massachusetts. Everything you own is boxed away and piled up in the middle of the floor. The reality of this move finally slams home as you stare at the sprawling jumble of stuff, and suddenly you feel very lost and adrift.

Night has now undeniably fallen, and the house is very, very dark. There is probably just enough residual ambience to feel your way upstairs to the bedroom, but the rest of the house is a tenebrous maze of shadows, and any exploring would probably best be done in the morning.

Michael stretches his arms and yawns. "Well," he says, "I think I'm going to turn in. There'll be plenty of time to unpack and explore tomorrow. Good night, hon." He kisses you on the cheek. "Don't stay up too late."

>u
Upstairs Landing
A narrow hallway runs east, from the top of the stairs down the length of the house. To the north, directly opposite the stairs, is the master bedroom.

* * *

>sleep
Something is nagging at you, preventing you from sleeping... suddenly you remember -- you've left the front door unlocked.

>s
Upstairs Landing
A narrow hallway runs east, from the top of the stairs down the length of the house. To the north, directly opposite the stairs, is the master bedroom.

>d
Foyer
Although it appears spacious from the outside, the house's interior feels cramped and gloomy. The walls seem too close together; the ceiling is too high. The doorways, leading in several directions, are narrow and filled with shadows, and the stairs leading up to the second floor are steep and rickety. This is not a house that makes you feel welcome. It is a house that makes you feel tiny and timid, and afraid of dark places. It is a house that makes you feel alone.

The front door stands open to the south.

Your luggage is still here, spread out all over the foyer.

>close door
You close the front door.

>u
Upstairs Landing
A narrow hallway runs east, from the top of the stairs down the length of the house. To the north, directly opposite the stairs, is the master bedroom.

>n
Master Bedroom
The master bedroom is a picture-postcard of rustic New England charm. Faded sketches of rural landscapes adorn the walls; a beautifully carved dressing mirror stands in one corner; an old-fashioned accordion radiator gurgles quietly beneath the window. The most striking feature, an enormous, antique, four-poster bed, must be the largest piece of furniture in the house.

Michael is curled up in bed, sound asleep.

>sleep
Something is nagging at you, preventing you from sleeping... suddenly you remember -- you've left the front door unlocked.

* * *

>d
Foyer
Although it appears spacious from the outside, the house's interior feels cramped and gloomy. The walls seem too close together; the ceiling is too high. The doorways, leading in several directions, are narrow and filled with shadows, and the stairs leading up to the second floor are steep and rickety. This is not a house that makes you feel welcome. It is a house that makes you feel tiny and timid, and afraid of dark places. It is a house that makes you feel alone.

Your luggage is still here, spread out all over the foyer.

>lock door
Maybe you need a key for that?

* * *

>nw. unlock door. n. u.
Outside the House
The lane runs up from the southeast and ends at a wide clearing surrounded by gnarled and ancient trees. A wide, curving driveway runs up to the front door of your house, which lies north.

The fabled Verlac family mansion looms before you in the gloom, its dark creaking presence dominating the clearing and, somehow, even though it is not visible through the trees, the entire valley. The foreboding shadow of the Verlacs seems to enshroud all of Anchorhead from here.

A typewritten notice has been attached to the front door.

Michael follows you.

You unlock the front door.

(first opening the front door)

Foyer
Although it appears spacious from the outside, the house's interior feels cramped and gloomy. The walls seem too close together; the ceiling is too high. The doorways, leading in several directions, are narrow and filled with shadows, and the stairs leading up to the second floor are steep and rickety. This is not a house that makes you feel welcome. It is a house that makes you feel tiny and timid, and afraid of dark places. It is a house that makes you feel alone.

The front door stands open to the south.

Carelessly stacked in a towering heap in the middle of the room are all your luggage and belongings, which you had sent ahead through a moving company before driving up to Massachusetts. Everything you own is boxed away and piled up in the middle of the floor. The reality of this move finally slams home as you stare at the sprawling jumble of stuff, and suddenly you feel very lost and adrift.

Night has now undeniably fallen, and the house is very, very dark. There is probably just enough residual ambience to feel your way upstairs to the bedroom, but the rest of the house is a tenebrous maze of shadows, and any exploring would probably best be done in the morning.

Michael stretches his arms and yawns. "Well," he says, "I think I'm going to turn in. There'll be plenty of time to unpack and explore tomorrow. Good night, hon." He kisses you on the cheek. "Don't stay up too late."

Upstairs Landing
A narrow hallway runs east, from the top of the stairs down the length of the house. To the north, directly opposite the stairs, is the master bedroom.

>n
You can't go that way.

* * *

>x volume
It's an old medieval tome dated in the early 1300s, written by one Galarian Academius desChamps.

>read it
It's an old medieval tome dated in the early 1300s, written by one Galarian Academius desChamps.

* * *

>w
Bathroom
A small chamber of cold, white tile and floral-print wallpaper. It sports a genuine, whitewashed, claw-foot bathtub with a shower attachment, which is a definite plus. The bedroom lies east.

>e
Master Bedroom
The master bedroom is a picture-postcard of rustic New England charm. Faded sketches of rural landscapes adorn the walls; a beautifully carved dressing mirror stands in one corner; an old-fashioned accordion radiator gurgles quietly beneath the window. The most striking feature, an enormous, antique, four-poster bed, must be the largest piece of furniture in the house.

Michael is curled up in bed, sound asleep.

Michael is here.

* * *

>n
Master Bedroom
The master bedroom is a picture-postcard of rustic New England charm. Faded sketches of rural landscapes adorn the walls; a beautifully carved dressing mirror stands in one corner; an old-fashioned accordion radiator gurgles quietly beneath the window. The most striking feature, an enormous, antique, four-poster bed, must be the largest piece of furniture in the house.

If it weren't for this hopelessly backwater town and the disturbing circumstances surrounding the house, you'd say this was your dream home. Even so, as much as you would like to relax and enjoy the comforts of a fully furnished historical New England estate, you can't help but be put off by the shady aura surrounding the family that used to live here. The last of the line, you remind yourself, recently committed suicide after killing his wife and two daughters with a shotgun. Involuntarily you shiver, glancing nervously at the doorways to the south and west.

Michael is curled up in bed, sound asleep.

>ask michael about verlac
Best not. He seems exhausted.

>show house key to michael.
Best not. He seems exhausted.

>sleep
You aren't feeling especially drowsy.

* * *

The oldest and strongest emotion of mankind
is fear, and the oldest and strongest kind of
fear is fear of the unknown.

-- H.P. Lovecraft
                                                                                                                                                                                                                                                  I N F O R M H E A D

Please press SPACE to continue.

>test hatch
(Testing.)

>[1] w

Narrow Street
As the lane winds along from east to west, it narrows until the steep, jagged rooftops on either side of the street practically touch each other. To the south, a side street leads across Whateley Bridge toward the center of town, and a twisting lane leads up a hill to the northwest. A short flight of steps to the north leads down to the local watering hole.

>[2] w

Junction
To the north, a gap in the crowded press of gloomy buildings opens onto a country lane, heading out over a grassy heath. The main street continues to the east, while to the northwest, over the top of a steep rise, you can just make out the vaulted rooftops of the university.

>[3] n

Mill Road
The road carries you across a desolate heath of gray, windswept grass. To the south, the black, jagged outline of Anchorhead's steep roofs and sharp, leaning gables cuts across the horizon. The road forks here to the west and east, heading across the railroad tracks in one direction, out toward the seashore in the other.

>[4] w
As you cross the railroad tracks, the air becomes warmer, more dingy, and slightly more difficult to breathe.

Entrance to the Paper Mill
The road turns southwest here and runs squarely through the front entrance to the old paper mill. A gate of heavy iron bars blocks the only opening into this charred fortress, although an overgrown path leads around the wall to the south. To the north, a rutted lane threads its way past a row of dilapidated shacks.

>[5] nw
The road goes north and east from here. The mill gate lies southwest, and an overgrown trail leads south.

>[6] s
The path curves southwest, leading you into an overgrown area behind the mill.

Bare Foundations
The foundations of an older structure lie crumbling in a sunken square of ground, hidden away behind the imposing shadow of the mill wall. Weeds push up through cracked and buckling slabs of concrete; twisted rebar and rusting pipes poke up like the legs of dead insects. The ruins are surrounded on all sides by dense thickets, although narrow, overgrown trails lead northeast and southeast through the underbrush.

>[7] e
The thickets are too dense in that direction.

>[8] n
The thickets are too dense in that direction.

>[9] search thicket
Carefully pushing the prickly branches aside, you find a rusty metal hatch set into the base of the wall.

>[10] l
Bare Foundations
The foundations of an older structure lie crumbling in a sunken square of ground, hidden away behind the imposing shadow of the mill wall. Weeds push up through cracked and buckling slabs of concrete; twisted rebar and rusting pipes poke up like the legs of dead insects. The ruins are surrounded on all sides by dense thickets, although narrow, overgrown trails lead northeast and southeast through the underbrush.

Set into the base of the mill wall, nearly covered by the thickets, is a metal hatch.

>[11] n
(first opening the hatch)
It seems to be locked.

>restart
Are you sure you want to restart?

* * *

>yes
Informhead
An Interactive Fiction by Ed Peters
Release 1 / Serial number 230519 / Inform 7 v10.1.2 / D

Outside the Real Estate Office
A grim little cul-de-sac, tucked away in a corner of the claustrophobic tangle of narrow, twisting avenues that largely constitute the older portion of Anchorhead. Like most of the streets in this city, it is ancient, shadowy, and leads essentially nowhere. The lane ends here at the real estate agent's office, which lies to the east, and winds its way back toward the center of town to the west. A narrow, garbage-choked alley opens to the southeast.

>e
(first opening the office door)
It seems to be locked.

>nw
You can't go that way.

>ne
You can't go that way.

>n
You can't go that way.

* * *

>x hatch
You see nothing special about the hatch.

* * *

>l
Bare Foundations
The foundations of an older structure lie crumbling in a sunken square of ground, hidden away behind the imposing shadow of the mill wall. Weeds push up through cracked and buckling slabs of concrete; twisted rebar and rusting pipes poke up like the legs of dead insects. The ruins are surrounded on all sides by dense thickets, although narrow, overgrown trails lead northeast and southeast through the underbrush.

Set into the base of the mill wall, nearly covered by the thickets, is a metal hatch.

>l
Bare Foundations
The foundations of an older structure lie crumbling in a sunken square of ground, hidden away behind the imposing shadow of the mill wall. Weeds push up through cracked and buckling slabs of concrete; twisted rebar and rusting pipes poke up like the legs of dead insects. The ruins are surrounded on all sides by dense thickets, although narrow, overgrown trails lead northeast and southeast through the underbrush.

Set into the base of the mill wall, nearly covered by the thickets, is a metal hatch.

>n
The thickets are too dense in that direction.

>open hatch
It seems to be locked.

* * *

>ask man about william
The old man squints at you with bleary, cunning eyes. "Don't know too much about that," he quavers. "Memory's not what it used to be... I'm so thirsty, Miss, so thirsty..."

>ask man about anna
The old man squints at you with bleary, cunning eyes. "Don't know too much about that," he quavers. "Memory's not what it used to be... I'm so thirsty, Miss, so thirsty..."

>give flask to man
His eyes burning with greed, the old man snatches the flask from your hand, unscrews the cap and tips it up into his waiting mouth. Trickles of pungent brown liquid ooze from the corners of his mouth as he swallows convulsively, his hands trembling, his eyes squeezed shut and streaming tears. Finally, he falls back onto his mattress with a beatific smile on his mud-smeared face, the flask dropping from his fingers.

[Your score has just gone up by two points.]

>ask man about anna
Tears stream unchecked down the old man's face. "Shouldn't have happened to the girl. Only seventeen, she was, still a child when he... when that red-eyed monster took her... " His eyes suddenly darken, his fists clench. "HIS OWN DAUGHTER, GODS FUCK "EM! SHOULDN'T HAVE DONE THAT TO HIS OWN DAUGHTER! GODS FUCK "EM ALL!!".

>ask man about himself
The old man screws his face up in confusion. "Don't know about that," he mutters.

>ask man about self
The old man sighs. "I was a doctor, once. I was a very good doctor. But that was before Edward, you know. Little Edward and his..." His voice trails off to a whisper, but you could swear he mouthed the word "brother".

>ask man about brother
The old man screws his face up in confusion. "Don't know about that," he mutters.

>ask man about anchorhead
The old man covers his face in his hands. "Not a town," he cries, "not a town -- a hive of BURROWING INSECTS! A SWARM OF MAGGOTS, THEY ARE!" He looks at you slyly. "But they can't find me, when the maggots come out. They can't find me in my hidey-hole.".

>ask man about edward
The old man lets out a vicious cackle. "They got to him, didn't they? Maggots got to him good. Got into his head. The maggots got into his head, eatin" at him "til he had to crack it open to get "em out. Poor boy." He shakes his head. "Delivered him, I did. Pulled him right out of his mama. Him and his -- " Suddenly he stops, and will say no more..

* * *

>ask old man about edward
The old man squints at you with bleary, cunning eyes. "Don't know too much about that," he quavers. "Memory's not what it used to be... I'm so thirsty, Miss, so thirsty..."

>ask old man about coffin
The old man squints at you with bleary, cunning eyes. "Don't know too much about that," he quavers. "Memory's not what it used to be... I'm so thirsty, Miss, so thirsty..."

"YOU CAN'T CATCH ME!" shrieks the old man suddenly. "I CAN GO WHERE YOU CAN'T GO!" He falls quiet again, rocking gently back and forth and clutching something to his chest.

>give flask to man
His eyes burning with greed, the old man snatches the flask from your hand, unscrews the cap and tips it up into his waiting mouth. Trickles of pungent brown liquid ooze from the corners of his mouth as he swallows convulsively, his hands trembling, his eyes squeezed shut and streaming tears. Finally, he falls back onto his mattress with a beatific smile on his mud-smeared face, the flask dropping from his fingers.

[Your score has just gone up by two points.]

>ask old man about coffin
*** Run-time problem P20: Attempt to look up a non-existent column in the table 'Table of Old Man One-Liners'.

The old man screws his face up in confusion. "Don't know about that," he mutters.

* * *

>give flask to man
His eyes burning with greed, the old man snatches the flask from your hand, unscrews the cap and tips it up into his waiting mouth. Trickles of pungent brown liquid ooze from the corners of his mouth as he swallows convulsively, his hands trembling, his eyes squeezed shut and streaming tears. Finally, he falls back onto his mattress with a beatific smile on his mud-smeared face, the flask dropping from his fingers.

[Your score has just gone up by two points.]

>ask man about edward
The old man lets out a vicious cackle. "They got to him, didn't they? Maggots got to him good. Got into his head. The maggots got into his head, eatin" at him "til he had to crack it open to get "em out. Poor boy." He shakes his head. "Delivered him, I did. Pulled him right out of his mama. Him and his -- " Suddenly he stops, and will say no more..

>ask man about coffin
*** Run-time problem P20: Attempt to look up a non-existent column in the table 'Table of Old Man One-Liners'.

The old man screws his face up in confusion. "Don't know about that," he mutters.

* * *

>ask man about edward
The old man lets out a vicious cackle. "They got to him, didn't they? Maggots got to him good. Got into his head. The maggots got into his head, eatin" at him "til he had to crack it open to get "em out. Poor boy." He shakes his head. "Delivered him, I did. Pulled him right out of his mama. Him and his -- " Suddenly he stops, and will say no more..

>ask man about foo
The old man screws his face up in confusion. "Don't know about that," he mutters.

>ask man about coffin
The old man screws his face up in confusion. "Don't know about that," he mutters.

* * *

>give flask to man
His eyes burning with greed, the old man snatches the flask from your hand, unscrews the cap and tips it up into his waiting mouth. Trickles of pungent brown liquid ooze from the corners of his mouth as he swallows convulsively, his hands trembling, his eyes squeezed shut and streaming tears. Finally, he falls back onto his mattress with a beatific smile on his mud-smeared face, the flask dropping from his fingers.

[Your score has just gone up by two points.]

>ask man about william
Foo.

>ask man about coffin
Bar.

>ask man about crypt
Bar.

>ask man about skull
The old man screws his face up in confusion. "Don't know about that," he mutters..

>ask man about edward
The old man lets out a vicious cackle. "They got to him, didn't they? Maggots got to him good. Got into his head. The maggots got into his head, eatin" at him "til he had to crack it open to get "em out. Poor boy." He shakes his head. "Delivered him, I did. Pulled him right out of his mama. Him and his -- " Suddenly he stops, and will say no more..

* * *

>give flask to man
His eyes burning with greed, the old man snatches the flask from your hand, unscrews the cap and tips it up into his waiting mouth. Trickles of pungent brown liquid ooze from the corners of his mouth as he swallows convulsively, his hands trembling, his eyes squeezed shut and streaming tears. Finally, he falls back onto his mattress with a beatific smile on his mud-smeared face, the flask dropping from his fingers.

[Your score has just gone up by two points.]

>l
Vacant Lot
Where once a building stood, there is now only cracked pavement and rampant weeds. A high chain-link fence surrounds this vacant lot; the only breaks lie to the west and southeast.

An old man dressed in dirty rags sits on his mattress, muttering to himself as he stares intently out to sea.

A filthy old mattress lies among the weeds over in one corner of the lot.

You can also see a flask (which is empty) here.

>take flask. give it to man.
You take the flask (which is empty).

The old man doesn't seem interested.

>drop flask
Dropped.

>ask man about coffin
Eh? What coffin d'you mean?.

I beg your pardon?

>ask man about coffin
Eh? What coffin d'you mean?.

>ask man about william
The old man falls silent all of a sudden, and for a while he simply stares down at his hands, limp and open in his lap. Then, drawing a deep breath, he begins to speak, and for the first time his voice is steady, without the reedy whine of alcoholic craving.

"Ayuh, little Edward had a brother, so he did. And I know him. I know of William, so I do. I delivered the child. Anna Verlac was his mother. It... it was... "

He leans over and grips your arm with a hand that is suddenly steady and strong. "It was her father's poison seed, y'see. That evil bastard poisoned her womb and put a monster inside her. What she gave birth to... it was... it wasn't... oh, God, when I held that... that abortion in the shape of an infant, that thing with hooves for feet and its crown of writhing... when it looked up at me... It looked up at me with its father's red-rimmed eyes." The old man shudders convulsively, and it is a while before he can speak again.

"Anna and I decided between ourselves, we did. The... her child... it lived for a few years, but it was sickly, and in pain, and it could never be normal nor healthy. She brought it to me... I was her doctor, you see, I'd seen her through her child's birth, and she trusted me... and I put the thing down, softly and without pain, and they laid it to rest in the family crypt.

"And Anna thanked me for it, so she did."

The old man falls silent again, and his wavering, bloodshot eyes wander once more out to sea. And he is lost, once again, to the horror and pain of the memories that can only be silenced by drink..

>ask man about william
"All I care to tell of that tragedy, I've told," the old man says quietly, not looking at you. "I've no wish to speak of it again.".

>ask man about william
"All I care to tell of that tragedy, I've told," the old man says quietly, not looking at you. "I've no wish to speak of it again.".

>ask man about coffin
The old man stares at you suspiciously. "William was buried in the family crypt, at his mother's request, so he was; what're you getting at?".

>ask man about coffin
"I told you about that already," snaps the old man. "Why don't you leave me alone?".

>ask man about coffin
"I told you about that already," snaps the old man. "Why don't you leave me alone?".

>show skull to man
You can't see any such thing.

>i
You are carrying:
  a cellar key
  a house key
  A Historical Overview of Superstitions by J. Arnsworth Frazer
  your umbrella
  your keyring
  Michael's faculty card
  your clothes (being worn)
  your trenchcoat (being worn)
  your wedding ring (being worn)

>purloin skull
[Purloined.]

>i
You are carrying:
  an animal's skull
  a cellar key
  a house key
  A Historical Overview of Superstitions by J. Arnsworth Frazer
  your umbrella
  your keyring
  Michael's faculty card
  your clothes (being worn)
  your trenchcoat (being worn)
  your wedding ring (being worn)

>show skull to man
The old man is unimpressed.

* * *

>give flask to man. ask man about edward.
His eyes burning with greed, the old man snatches the flask from your hand, unscrews the cap and tips it up into his waiting mouth. Trickles of pungent brown liquid ooze from the corners of his mouth as he swallows convulsively, his hands trembling, his eyes squeezed shut and streaming tears. Finally, he falls back onto his mattress with a beatific smile on his mud-smeared face, the flask dropping from his fingers.

[Your score has just gone up by two points.]

*** Run-time problem P29: Attempt to see if a snippet of text matches something which is not a topic.

The old man screws his face up in confusion. "Don't know about that," he mutters..

>ask man about william
*** Run-time problem P29: Attempt to see if a snippet of text matches something which is not a topic.

The old man screws his face up in confusion. "Don't know about that," he mutters..

* * *

>give flask to man. ask man about wilhelm
His eyes burning with greed, the old man snatches the flask from your hand, unscrews the cap and tips it up into his waiting mouth. Trickles of pungent brown liquid ooze from the corners of his mouth as he swallows convulsively, his hands trembling, his eyes squeezed shut and streaming tears. Finally, he falls back onto his mattress with a beatific smile on his mud-smeared face, the flask dropping from his fingers.

[Your score has just gone up by two points.]

There is no reply.

>give flask to man. ask man about wilhelm
(first taking the flask (which is empty))
The old man doesn't seem interested.

There is no reply.

>ask man about william
There is no reply.

* * *

>purloin skull
[Purloined.]

>ask man about william
The old man squints at you with bleary, cunning eyes. "Don't know too much about that," he quavers. "Memory's not what it used to be... I'm so thirsty, Miss, so thirsty...".

>give flask to man
His eyes burning with greed, the old man snatches the flask from your hand, unscrews the cap and tips it up into his waiting mouth. Trickles of pungent brown liquid ooze from the corners of his mouth as he swallows convulsively, his hands trembling, his eyes squeezed shut and streaming tears. Finally, he falls back onto his mattress with a beatific smile on his mud-smeared face, the flask dropping from his fingers.

[Your score has just gone up by two points.]

>ask man about william
The old man falls silent all of a sudden, and for a while he simply stares down at his hands, limp and open in his lap. Then, drawing a deep breath, he begins to speak, and for the first time his voice is steady, without the reedy whine of alcoholic craving.

"Ayuh, little Edward had a brother, so he did. And I know him. I know of William, so I do. I delivered the child. Anna Verlac was his mother. It... it was... "

He leans over and grips your arm with a hand that is suddenly steady and strong. "It was her father's poison seed, y'see. That evil bastard poisoned her womb and put a monster inside her. What she gave birth to... it was... it wasn't... oh, God, when I held that... that abortion in the shape of an infant, that thing with hooves for feet and its crown of writhing... when it looked up at me... It looked up at me with its father's red-rimmed eyes." The old man shudders convulsively, and it is a while before he can speak again.

"Anna and I decided between ourselves, we did. The... her child... it lived for a few years, but it was sickly, and in pain, and it could never be normal nor healthy. She brought it to me... I was her doctor, you see, I'd seen her through her child's birth, and she trusted me... and I put the thing down, softly and without pain, and they laid it to rest in the family crypt.

"And Anna thanked me for it, so she did."

The old man falls silent again, and his wavering, bloodshot eyes wander once more out to sea. And he is lost, once again, to the horror and pain of the memories that can only be silenced by drink..

>ask man about anna
Tears stream unchecked down the old man's face. "Shouldn't have happened to the girl. Only seventeen, she was, still a child when he... when that red-eyed monster took her... " His eyes suddenly darken, his fists clench. "HIS OWN DAUGHTER, GODS FUCK "EM! SHOULDN'T HAVE DONE THAT TO HIS OWN DAUGHTER! GODS FUCK "EM ALL!!".

>ask man about edward
The old man lets out a vicious cackle. "They got to him, didn't they? Maggots got to him good. Got into his head. The maggots got into his head, eatin" at him "til he had to crack it open to get "em out. Poor boy." He shakes his head. "Delivered him, I did. Pulled him right out of his mama. Him and his -- " Suddenly he stops, and will say no more..

>ask man about coffin
The old man stares at you suspiciously. "William was buried in the family crypt, at his mother's request, so he was; what're you getting at?".

>show skull to man
The old man grows sickly pale. He raises one hand, as if to ward off the sight of the skull, deny the truth one more time; then his hand drops, and he sinks down onto the mattress, groaning.

"Oh, it's true," he cries, "it's true, God help my lying soul. It was her father who wished to kill the thing, not Anna -- kill it to make way for another, he said, a "more fitting vessel". He wanted to try again -- Gods, the depth of his evil -- after the way the first one came out, he wanted to try again!

"Anna came to me and asked for my help, and what could I do? What could I do? It was her child, for God's sake, no matter what else it was, and she couldn't bear to lose it. But we had to weigh the coffin down with something..."

He sits up, suddenly, fastening on you with a sick, pleading look.

"I've told you too much, now," he whispers desperately. "They'll know; the maggots'll find out for sure. They'll find me; even in my hole, they'll find me." He lets out an eye-wateringly pungent breath, "P'raps it's best they do. I've spent so long drowning my sins, p'raps time's come to pay for them at last. This won't do me much good no more," he says, holding up his little copper key. "And yet..." He closes his fist around it again. "And yet, maybe there's a way... they say there's ways to protect yourself, wards versus the Evil Eye and such. Perhaps, if I could get me one o'those...

>show amulet to man
You can't see any such thing.

>purloin amulet
[Purloined.]

>show amulet to man
"Thank you kindly, Miss, you're a generous one, so you are," grins the old man as he closes his grimy fingers around the charm. "And here y'are," he says, tossing you the copper key. "I'll pray it does you good."

The old man staggers to his feet. "I'll be gettin" on, then," he says. "If I can make away before nightfall, p'raps I'll be out of their reach before the maggots come out." He wraps the leather thong around his hand and closes the charm in his fist.

He turns to you one last time. "Don't let them find you," he says earnestly. "Get out while you can. If you stay, they'll track you down eventually. It's the blood. He can smell it, so he can. And he always returns to his blood."

He shambles off, up the riverwalk toward Town Square, his shadow dragging long behind him. Looking to the sky, you realize that the sun is nearly set; you've been talking to the old man for much longer than you thought, and it will be dark soon.

[Your score has just gone up by five points.]

>scenes
Scene 'Entire Game' playing (for 71 mins now)
Scene 'Day 1' ended
Scene 'Michael Reads' ended
Scene 'Michael Follows' ended
Scene 'Michael Sleeps' ended
Scene 'Day 2' playing (for 33 mins now)
Scene 'Betrayal' ended
Scene 'Michael Writes' ended
Scene 'Close of Day' playing (for 1 mins now)
(Scene monitoring now switched on. Type "scenes off" to switch it off again.)

* * *

>purloin skull
[Purloined.]

>give flask to man. ask man about william.
His eyes burning with greed, the old man snatches the flask from your hand, unscrews the cap and tips it up into his waiting mouth. Trickles of pungent brown liquid ooze from the corners of his mouth as he swallows convulsively, his hands trembling, his eyes squeezed shut and streaming tears. Finally, he falls back onto his mattress with a beatific smile on his mud-smeared face, the flask dropping from his fingers.

[Your score has just gone up by two points.]

The old man screws his face up in confusion. "Don't know about that," he mutters..

>ask man about william.
The old man screws his face up in confusion. "Don't know about that," he mutters..

>ask man about coffin
Eh? What coffin d'you mean?.

>ask man about anna
Tears stream unchecked down the old man's face. "Shouldn't have happened to the girl. Only seventeen, she was, still a child when he... when that red-eyed monster took her... " His eyes suddenly darken, his fists clench. "HIS OWN DAUGHTER, GODS FUCK "EM! SHOULDN'T HAVE DONE THAT TO HIS OWN DAUGHTER! GODS FUCK "EM ALL!!".

>ask man about william
The old man falls silent all of a sudden, and for a while he simply stares down at his hands, limp and open in his lap. Then, drawing a deep breath, he begins to speak, and for the first time his voice is steady, without the reedy whine of alcoholic craving.

"Ayuh, little Edward had a brother, so he did. And I know him. I know of William, so I do. I delivered the child. Anna Verlac was his mother. It... it was... "

He leans over and grips your arm with a hand that is suddenly steady and strong. "It was her father's poison seed, y'see. That evil bastard poisoned her womb and put a monster inside her. What she gave birth to... it was... it wasn't... oh, God, when I held that... that abortion in the shape of an infant, that thing with hooves for feet and its crown of writhing... when it looked up at me... It looked up at me with its father's red-rimmed eyes." The old man shudders convulsively, and it is a while before he can speak again.

"Anna and I decided between ourselves, we did. The... her child... it lived for a few years, but it was sickly, and in pain, and it could never be normal nor healthy. She brought it to me... I was her doctor, you see, I'd seen her through her child's birth, and she trusted me... and I put the thing down, softly and without pain, and they laid it to rest in the family crypt.

"And Anna thanked me for it, so she did."

The old man falls silent again, and his wavering, bloodshot eyes wander once more out to sea. And he is lost, once again, to the horror and pain of the memories that can only be silenced by drink..

* * *

>purloin amulet
[Purloined.]

>give amulet to man
"Thank you kindly, Miss, you're a generous one, so you are," grins the old man as he closes his grimy fingers around the charm. "And here y'are," he says, tossing you the copper key. "I'll pray it does you good."

The old man staggers to his feet. "I'll be gettin" on, then," he says. "If I can make away before nightfall, p'raps I'll be out of their reach before the maggots come out." He wraps the leather thong around his hand and closes the charm in his fist.

He turns to you one last time. "Don't let them find you," he says earnestly. "Get out while you can. If you stay, they'll track you down eventually. It's the blood. He can smell it, so he can. And he always returns to his blood."

He shambles off, up the riverwalk toward Town Square, his shadow dragging long behind him. Looking to the sky, you realize that the sun is nearly set; you've been talking to the old man for much longer than you thought, and it will be dark soon.

[Your score has just gone up by five points.]

>w
Riverwalk
A low, irregular brick wall to the north divides this street from the steep, mud-slick banks of the sinuous Miskaton, while a rusty iron gate provides access to a precarious flight of stone steps leading down the bank to the water's edge. The street bends south here, turning into a misty avenue between the trees. The town square lies west, a vacant lot lies east.

>n
The street leads to the west and to the south. A vacant lot lies east and a rusty gate lies to the north.

>n
The street leads to the west and to the south. A vacant lot lies east and a rusty gate lies to the north.

>d
Under the Bridge
The ponderous stones of Whateley Bridge arch overhead, casting this little concrete ledge into deep shadow. At your feet, the dark waters lap quietly against the stones with a hollow, subterranean sound. Stone steps to the southeast lead back up to street level.

A small metal door, blotchy with rust, is set into the south bank of the river, underneath the bridge.

>unlock door
(with the small copper key)
You unlock the small metal door.

>s
(first opening the small metal door)

Darkness
It is pitch dark, and you can't see a thing.

>turn on light
You can't see any such thing.

* * *

>purloin light
[Purloined.]

>turn on light
You switch the flashlight on.

Access Shaft
This tiny, concrete-lined alcove within the underside of the bridge forms the top of a vertical shaft leading down into darkness. Iron rungs embedded in the wall provide a way down.

A small metal door, blotchy with rust, is set into the south bank of the river, underneath the bridge.

>d
Sewer Tunnel
The tunnel is ankle-deep in brackish water, though raised walkways on either side provide relatively dry footing. The walls are slick, the air damp and foul. The main tunnel runs north and southeast. Numerous smaller pipelines lead in all directions, but all are too small for you to crawl through. Iron rungs embedded in the wall lead up through an access shaft, back to the surface.

>x ladder
It's an ordinary wooden ladder.

>s
You can't go that way.

>se
Vaulted Tunnel
The walls of this long, rectangular chamber are made of crumbling brick, not concrete; most likely it was built at some earlier period than the rest of the tunnels. The ceiling is lost in darkness above you, but from the sounds of the echoes it must be pretty high. Water flowing in from the northwestern tunnel has pooled in a depression sunk into the limestone floor, becoming quite deep near the far end.

>e
You can't go that way.

>nw
Sewer Tunnel
The tunnel is ankle-deep in brackish water, though raised walkways on either side provide relatively dry footing. The walls are slick, the air damp and foul. The main tunnel runs north and southeast. Numerous smaller pipelines lead in all directions, but all are too small for you to crawl through. Iron rungs embedded in the wall lead up through an access shaft, back to the surface.

>n
Dripping Tunnel
The ceiling in this north-south tunnel is so low you must bend nearly double to navigate it. Water drips endlessly through the walls and ceiling, seeping in through thousands of invisible fissures, the constant plip-plip-plipping echoing loudly throughout the tunnel. The air is so damp you can hardly breathe. Unless your sense of direction is mistaken, you must be crossing the Miskaton River -- underneath it.

>n
Broken Tunnel
This looks to be an older part of the sewer system that has fallen into disrepair. Many of the pipes here have crumbled and are filled with debris.

Set in the low ceiling is an old iron hatch.

>x pipes
The pipes are broken and jagged, filled with debris and thick slime.

>open hatch
You dig your fingers under the edge and tug, but the hinges are rusted nearly solid. You can't make it budge.

>u
(first opening the old iron hatch)
You dig your fingers under the edge and tug, but the hinges are rusted nearly solid. You can't make it budge.

>s
Dripping Tunnel
The ceiling in this north-south tunnel is so low you must bend nearly double to navigate it. Water drips endlessly through the walls and ceiling, seeping in through thousands of invisible fissures, the constant plip-plip-plipping echoing loudly throughout the tunnel. The air is so damp you can hardly breathe. Unless your sense of direction is mistaken, you must be crossing the Miskaton River -- underneath it.

>s
Sewer Tunnel
The tunnel is ankle-deep in brackish water, though raised walkways on either side provide relatively dry footing. The walls are slick, the air damp and foul. The main tunnel runs north and southeast. Numerous smaller pipelines lead in all directions, but all are too small for you to crawl through. Iron rungs embedded in the wall lead up through an access shaft, back to the surface.

>s
You can't go that way.

>s
You can't go that way.

I beg your pardon?

>listen
You hear nothing unexpected.

* * *

>purloin skull
[Purloined.]

>show skull to man
Foo.
Bob.

* * *

>yes
Informhead
An Interactive Fiction by Ed Peters
Release 1 / Serial number 230530 / Inform 7 v10.1.2 / D

Outside the Real Estate Office
A grim little cul-de-sac, tucked away in a corner of the claustrophobic tangle of narrow, twisting avenues that largely constitute the older portion of Anchorhead. Like most of the streets in this city, it is ancient, shadowy, and leads essentially nowhere. The lane ends here at the real estate agent's office, which lies to the east, and winds its way back toward the center of town to the west. A narrow, garbage-choked alley opens to the southeast.

>w. w.
Narrow Street
As the lane winds along from east to west, it narrows until the steep, jagged rooftops on either side of the street practically touch each other. To the south, a side street leads across Whateley Bridge toward the center of town, and a twisting lane leads up a hill to the northwest. A short flight of steps to the north leads down to the local watering hole.

A sudden gust of wind blows a cold spray of rain into your face.

Junction
To the north, a gap in the crowded press of gloomy buildings opens onto a country lane, heading out over a grassy heath. The main street continues to the east, while to the northwest, over the top of a steep rise, you can just make out the vaulted rooftops of the university.

>nw.
University Court
Isolated and serene within its high, ivy-covered walls, Miskaton University represents this benighted town's single, if somewhat dubious, claim to cultural achievement. Founded some time in the early 1800s, the school's reputation and enrollment have diminished somewhat as Anchorhead drifts further and further into the abyss of provincial backwaterism. Still, it is generally recognized for its collection of folklore and esoteric mythology (one of the oldest and most extensive on the east coast). The Board of Deans was also kind enough to offer Michael a full professorship upon hearing of his recently discovered heritage and his plans to move into the estate. Ivory tower, perhaps, but at least they take care of their own.

There are numerous buildings surrounding this cobbled court, but the only one you are interested in is the library to the west, where Michael told you he'd be until he came back to the real estate agent's office to pick you up. Which, incidentally, he has not yet done.

>w
University Library
Shadows roost thickly in the vaulted ceiling, and small, green-shaded desk lamps cast pools of warm radiance here and there around the library's dim interior. You pause a moment to let the hushed peacefulness of this place soak in -- a welcome relief from the unsettling events of the day. An exit lies east, and a small alcove to the north houses the circulation counter.

Peering through the shadows, you spot your husband sitting at one of the reading desks, absorbed in some sort of weighty tome and clearly oblivious to the time.

>e
You're not allowed to leave the library with the book.

>i
You are carrying:
  A Historical Overview of Superstitions by J. Arnsworth Frazer
  your clothes (being worn)
  your trenchcoat (being worn)
  your wedding ring (being worn)
  your umbrella
  your keyring

>restart
Are you sure you want to restart?

* * *

>yes
Informhead
An Interactive Fiction by Ed Peters
Release 1 / Serial number 230530 / Inform 7 v10.1.2 / D

Outside the Real Estate Office
A grim little cul-de-sac, tucked away in a corner of the claustrophobic tangle of narrow, twisting avenues that largely constitute the older portion of Anchorhead. Like most of the streets in this city, it is ancient, shadowy, and leads essentially nowhere. The lane ends here at the real estate agent's office, which lies to the east, and winds its way back toward the center of town to the west. A narrow, garbage-choked alley opens to the southeast.

>i
You are carrying:
  A Historical Overview of Superstitions by J. Arnsworth Frazer
  your clothes (being worn)
  your trenchcoat (being worn)
  your wedding ring (being worn)
  your umbrella
  your keyring

* * *

>w. n. n. n. s.
Town Square
A wide expanse of uneven pavestones lies open to the sky, bordered on all sides by the leaning, steep-roofed architecture that looms over everything in this city. The municipal courthouse stands at the south end of the square, next to the mouth of a dark, narrow alley to the southwest. Avenues to the west and east lead back into the cramped and ingrown streets, while to the north lies Whateley Bridge.

In the center of the square, rising from a circular lawn of unhealthy-looking grass and weeds, stands a strange, stone obelisk. It seems to be a monument of some sort, although you can see no plaque or marker anywhere near it.

A damp newspaper lies on the curb, fluttering slightly in the wind.

Whateley Bridge
A hoary monument of crumbling, moss-eaten flagstones, Whateley Bridge is possibly older than any other structure in the entire city. Ponderously it spans the dark, torpid waters of the Miskaton River, connecting the north and south halves of the city and occasionally raining bits of gravel and mortar from its underside into the water. It looks just wide enough for two cars to pass each other between the flanking stone parapets, but you wouldn't volunteer to try it.

Narrow Street
As the lane winds along from east to west, it narrows until the steep, jagged rooftops on either side of the street practically touch each other. To the south, a side street leads across Whateley Bridge toward the center of town, and a twisting lane leads up a hill to the northwest. A short flight of steps to the north leads down to the local watering hole.

Local Pub
A dank, drafty old drinking hole lit by flickering, oil-burning lanterns. Smoke collects in greasy pools among the rafters, and shadows crowd thick around. The bar runs the length of the room to your right, while to the south a low doorway opens onto the street.

Mill workers and fishermen occupy a few of the tables, drinking beer or puffing grimly at long-stemmed pipes. Each is wrapped in his solitude, soaking up the general miasma of dreary fatalism.

The lantern sitting on the table nearest you sputters fitfully, throwing distorted shadows across the wall.

As you make your way to the door, your foot strikes something under one of the tables.

* * *

>x man
You see nothing special about the old man.

* * *

The oldest and strongest emotion of mankind
is fear, and the oldest and strongest kind of
fear is fear of the unknown.

-- H.P. Lovecraft
                                                                                                                                                                                                                                                  I N F O R M H E A D

Please press SPACE to continue.

>test mfollows
(Testing.)

>[1] e
(first opening the office door)
It seems to be locked.

>[2] se

Alley
This narrow aperture between two buildings is nearly blocked with piles of rotting cardboard boxes and overstuffed garbage cans. Ugly, half-crumbling brick walls to either side totter oppressively over you. The alley ends here at a tall, wooden fence.

High up on the wall of the northern building there is a narrow, transom-style window. 

>[3] e
You can only exit the alley to the northwest.

>[4] s
You can only exit the alley to the northwest.

>[5] s
You can only exit the alley to the northwest.

>[6] e
You can only exit the alley to the northwest.

>[7] s
You can only exit the alley to the northwest.

>[8] sw
You can only exit the alley to the northwest.

>[9] nw

Outside the Real Estate Office
A grim little cul-de-sac, tucked away in a corner of the claustrophobic tangle of narrow, twisting avenues that largely constitute the older portion of Anchorhead. Like most of the streets in this city, it is ancient, shadowy, and leads essentially nowhere. The lane ends here at the real estate agent's office, which lies to the east, and winds its way back toward the center of town to the west. A narrow, garbage-choked alley opens to the southeast.

>[10] n
You can't go that way.

>[11] unlock door
Maybe you need a key for that?

>[12] n
You can't go that way.

>restart
Are you sure you want to restart?

* * *

>test msleeps
(Testing.)

>[1] u

Upstairs Landing
A narrow hallway runs east, from the top of the stairs down the length of the house. To the north, directly opposite the stairs, is the master bedroom.

>[2] n

Master Bedroom
The master bedroom is a picture-postcard of rustic New England charm. Faded sketches of rural landscapes adorn the walls; a beautifully carved dressing mirror stands in one corner; an old-fashioned accordion radiator gurgles quietly beneath the window. The most striking feature, an enormous, antique, four-poster bed, must be the largest piece of furniture in the house.

If it weren't for this hopelessly backwater town and the disturbing circumstances surrounding the house, you'd say this was your dream home. Even so, as much as you would like to relax and enjoy the comforts of a fully furnished historical New England estate, you can't help but be put off by the shady aura surrounding the family that used to live here. The last of the line, you remind yourself, recently committed suicide after killing his wife and two daughters with a shotgun. Involuntarily you shiver, glancing nervously at the doorways to the south and west.

Michael is curled up in bed, sound asleep.

>[3] sleep
Something is nagging at you, preventing you from sleeping... suddenly you remember -- you've left the front door unlocked.

>[4] s

Upstairs Landing
A narrow hallway runs east, from the top of the stairs down the length of the house. To the north, directly opposite the stairs, is the master bedroom.

>[5] d

Foyer
Although it appears spacious from the outside, the house's interior feels cramped and gloomy. The walls seem too close together; the ceiling is too high. The doorways, leading in several directions, are narrow and filled with shadows, and the stairs leading up to the second floor are steep and rickety. This is not a house that makes you feel welcome. It is a house that makes you feel tiny and timid, and afraid of dark places. It is a house that makes you feel alone.

The front door stands open to the south.

Your luggage is still here, spread out all over the foyer.

>[6] close door
You close the front door.

>[7] lock it
You lock the front door.

>[8] u

Upstairs Landing
A narrow hallway runs east, from the top of the stairs down the length of the house. To the north, directly opposite the stairs, is the master bedroom.

>n
Master Bedroom
The master bedroom is a picture-postcard of rustic New England charm. Faded sketches of rural landscapes adorn the walls; a beautifully carved dressing mirror stands in one corner; an old-fashioned accordion radiator gurgles quietly beneath the window. The most striking feature, an enormous, antique, four-poster bed, must be the largest piece of furniture in the house.

Michael is curled up in bed, sound asleep.

* * *

>e
University Court
Isolated and serene within its high, ivy-covered walls, Miskaton University represents this benighted town's single, if somewhat dubious, claim to cultural achievement. Founded some time in the early 1800s, the school's reputation and enrollment have diminished somewhat as Anchorhead drifts further and further into the abyss of provincial backwaterism. Still, it is generally recognized for its collection of folklore and esoteric mythology (one of the oldest and most extensive on the east coast). The Board of Deans was also kind enough to offer Michael a full professorship upon hearing of his recently discovered heritage and his plans to move into the estate. Ivory tower, perhaps, but at least they take care of their own.

There are numerous buildings surrounding this cobbled court, but the only one you are interested in is the library to the west, where Michael told you he'd be until he came back to the real estate agent's office to pick you up. Which, incidentally, he has not yet done.

Michael follows you.

>l
University Court
Isolated and serene within its high, ivy-covered walls, Miskaton University represents this benighted town's single, if somewhat dubious, claim to cultural achievement. Founded some time in the early 1800s, the school's reputation and enrollment have diminished somewhat as Anchorhead drifts further and further into the abyss of provincial backwaterism. Still, it is generally recognized for its collection of folklore and esoteric mythology (one of the oldest and most extensive on the east coast). The Board of Deans was also kind enough to offer Michael a full professorship upon hearing of his recently discovered heritage and his plans to move into the estate. Ivory tower, perhaps, but at least they take care of their own.

There are numerous buildings surrounding this cobbled court, but the only one you are interested in is the library to the west, where Michael told you he'd be until he came back to the real estate agent's office to pick you up. Which, incidentally, he has not yet done.

Michael is here.

>x michael
Tall and a bit on the skinny side, in an endearingly awkward sort of way; a serious, thoughtful face topped with an unruly tangle of brown hair; deep brown eyes framed by wire-rimmed glasses -- yep, that's the man you married, all right.Michael looks at you expectantly, waiting for you to lead the way.

* * *

>w
Junction
To the north, a gap in the crowded press of gloomy buildings opens onto a country lane, heading out over a grassy heath. The main street continues to the east, while to the northwest, over the top of a steep rise, you can just make out the vaulted rooftops of the university.

* * *

The oldest and strongest emotion of mankind
is fear, and the oldest and strongest kind of
fear is fear of the unknown.

-- H.P. Lovecraft
                                                                                                                                                                                                                                                  I N F O R M H E A D

Please press SPACE to continue.

>test mist
(Testing.)

>[1] w

Narrow Street
As the lane winds along from east to west, it narrows until the steep, jagged rooftops on either side of the street practically touch each other. To the south, a side street leads across Whateley Bridge toward the center of town, and a twisting lane leads up a hill to the northwest. A short flight of steps to the north leads down to the local watering hole.

>[2] s

Whateley Bridge
A hoary monument of crumbling, moss-eaten flagstones, Whateley Bridge is possibly older than any other structure in the entire city. Ponderously it spans the dark, torpid waters of the Miskaton River, connecting the north and south halves of the city and occasionally raining bits of gravel and mortar from its underside into the water. It looks just wide enough for two cars to pass each other between the flanking stone parapets, but you wouldn't volunteer to try it.

>[3] s

Town Square
A wide expanse of uneven pavestones lies open to the sky, bordered on all sides by the leaning, steep-roofed architecture that looms over everything in this city. The municipal courthouse stands at the south end of the square, next to the mouth of a dark, narrow alley to the southwest. Avenues to the west and east lead back into the cramped and ingrown streets, while to the north lies Whateley Bridge.

In the center of the square, rising from a circular lawn of unhealthy-looking grass and weeds, stands a strange, stone obelisk. It seems to be a monument of some sort, although you can see no plaque or marker anywhere near it.

>[4] e

Riverwalk
A low, irregular brick wall to the north divides this street from the steep, mud-slick banks of the sinuous Miskaton, while a rusty iron gate provides access to a precarious flight of stone steps leading down the bank to the water's edge. The street bends south here, turning into a misty avenue between the trees. The town square lies west, a vacant lot lies east.

>[5] s

Chilly Avenue
Perhaps it is merely the effect of some unwholesome vapour rising from the murky waters of the nearby Miskaton, but the temperature along this street seems perceptibly cooler than normal, even for a New England autumn. Two dirt roads lead south and southwest, into the dense woods at the edge of town.

A clammy mist hangs thickly in the air, seeping through your clothes and making you shiver.

>[6] sw
Before you can take more than a few steps, the mist coils its tendrils around you, freezing your marrow with its damp embrace. For one terrifying moment you can feel it probing at your mouth and nostrils, seeking a way in, and then with a sudden wrench you are free, gasping and choking and eyeing the mist with newfound wariness.

* * *

>test msleeps
(Testing.)

>[1] u

Upstairs Landing
A narrow hallway runs east, from the top of the stairs down the length of the house. To the north, directly opposite the stairs, is the master bedroom.

>[2] n

Master Bedroom
The master bedroom is a picture-postcard of rustic New England charm. Faded sketches of rural landscapes adorn the walls; a beautifully carved dressing mirror stands in one corner; an old-fashioned accordion radiator gurgles quietly beneath the window. The most striking feature, an enormous, antique, four-poster bed, must be the largest piece of furniture in the house.

If it weren't for this hopelessly backwater town and the disturbing circumstances surrounding the house, you'd say this was your dream home. Even so, as much as you would like to relax and enjoy the comforts of a fully furnished historical New England estate, you can't help but be put off by the shady aura surrounding the family that used to live here. The last of the line, you remind yourself, recently committed suicide after killing his wife and two daughters with a shotgun. Involuntarily you shiver, glancing nervously at the doorways to the south and west.

Michael is curled up in bed, sound asleep.

>[3] sleep
You really should get in bed first.

>[4] s

Upstairs Landing
A narrow hallway runs east, from the top of the stairs down the length of the house. To the north, directly opposite the stairs, is the master bedroom.

>[5] d

Foyer
Although it appears spacious from the outside, the house's interior feels cramped and gloomy. The walls seem too close together; the ceiling is too high. The doorways, leading in several directions, are narrow and filled with shadows, and the stairs leading up to the second floor are steep and rickety. This is not a house that makes you feel welcome. It is a house that makes you feel tiny and timid, and afraid of dark places. It is a house that makes you feel alone.

The front door stands open to the south.

Your luggage is still here, spread out all over the foyer.

>[6] close door
You close the front door.

>[7] lock it
You lock the front door.

>[8] u

Upstairs Landing
A narrow hallway runs east, from the top of the stairs down the length of the house. To the north, directly opposite the stairs, is the master bedroom.

>[9] n

Master Bedroom
The master bedroom is a picture-postcard of rustic New England charm. Faded sketches of rural landscapes adorn the walls; a beautifully carved dressing mirror stands in one corner; an old-fashioned accordion radiator gurgles quietly beneath the window. The most striking feature, an enormous, antique, four-poster bed, must be the largest piece of furniture in the house.

Michael is curled up in bed, sound asleep.

>sleep
You really should get in bed first.

>get in bed
You get onto the bed.

>i
You are carrying:
  your wedding ring (being worn)

>l
Master Bedroom (on the bed)
The master bedroom is a picture-postcard of rustic New England charm. Faded sketches of rural landscapes adorn the walls; a beautifully carved dressing mirror stands in one corner; an old-fashioned accordion radiator gurgles quietly beneath the window. The most striking feature, an enormous, antique, four-poster bed, must be the largest piece of furniture in the house.

Michael is curled up in bed, sound asleep.

You can also see a house key and a cellar key here.

* * *

>u
Upstairs Landing
A narrow hallway runs east, from the top of the stairs down the length of the house. To the north, directly opposite the stairs, is the master bedroom.

>test study
(Testing.)

>[1] e

Upstairs Hall
The shuttered window at the end of the hall throws a gloomy rectangle of light onto the bare wooden floor. Doorways lead north and south.

>[2] n

Library
Whatever else their faults may have been, the Verlacs were evidently not ones to shun the printed word. Books line the walls from floor to ceiling in this dark-paneled, green-carpeted room, interrupted only by doorways to the east and south. A rich, brown leather armchair sits in stately repose near the window, with a polished brass pipe stand nearby completing the picture of some blue-blooded country squire's literary refuge. Once again, you are struck by how easily this place could have been the perfect home.

A beautiful pair of mahogany sliding doors stand closed to the east.

>[3] x chair
It's the kind of furniture that you always drool over in catalogs, and it looks about as comfortable as an armchair ever gets without an added shot of heroin.

>[4] x stand
It's a beautiful piece of work, although at the moment, sadly, it contains no pipe.

>[5] take book
You can't see any such thing.

>[6] read book
You can't see any such thing.

>[7] drop book
You can't see any such thing.

>[8] x doors
Each door is carved from a single piece of mahogany, and polished to a deep, rich shine. The doors are closed.

* * *

>x radiator
The radiator runs on gas, not electricity, which is why it's even working at all. It's quiet and it keeps the room cozy, which is all you really need it to do, so everything seems to be in order there.

>x sketches
The sketches are charcoal on yellowed paper, pictures of the surrounding countryside. They're quite pretty, actually, lending an air of comfort to an otherwise cold and moribund house. Each drawing is initialed in the corner - "J.W.V. - "95"

>x bed
Thick, goose-down mattress, linen sheets, feather pillows, gauze canopy -- it's about the most beautiful, inviting bed you've ever seen.

>get in bed
That's not something you can enter.

>enter bed
That's not something you can enter.

>stand on bed
That's not something you can stand on.

* * *

>get in bed
You get onto the bed.

>l
Master Bedroom (on the bed)
The master bedroom is a picture-postcard of rustic New England charm. Faded sketches of rural landscapes adorn the walls; a beautifully carved dressing mirror stands in one corner; an old-fashioned accordion radiator gurgles quietly beneath the window. The most striking feature, an enormous, antique, four-poster bed, must be the largest piece of furniture in the house.

Michael is curled up in bed, sound asleep.

You can also see a house key and a cellar key here.

>i
You are carrying:
  your wedding ring (being worn)

* * *

>x slot
It looks as though it might be a receptacle of some kind, perhaps for a special lens.

>put house key in slot
The house key won't fit properly into the slot.

>put disk in slot
You put the strange black disk into the slot.

>l
Observatory
You are in a small, enclosed cupola situated, by the look of the view through the dingy skylight over your head, on top of the roof of the house. The walls are covered with astrological and astronomical charts with equations and diagrams scribbled across them in crabbed, stilted handwriting. The only exit seems to be an oddly-angled corridor to the southeast.

>x slot
It looks as though it might be a receptacle of some kind, perhaps for a special lens.

In the slot is a strange black disk.

>search telescope
...you wake up some time later, shaking your head. You're not sure what, exactly, you just witnessed; whether it was a genuine astronomical phenomenon, or a hallucination, or the actual form of some Dark God from the Outer Reaches, come to devour the world. You're not even entirely sure you remember what it looked like. The only thing you can clearly recall is a single name, pulsing in your brain like a bruise:

"Ialdabaoloth".

And that's all.

[Your score has just gone up by five points.]

>examine telescope
Constructed of some greenish metal, the telescope consists in the main of an unadorned cylinder about eight inches in diameter, with an eyepiece near the bottom. Near the top, about six inches down from the telescope's upper end, is a thin, rectangular slot, cut horizontally into the side of the cylinder.

>search telescope
...you wake up some time later, shaking your head. You're not sure what, exactly, you just witnessed; whether it was a genuine astronomical phenomenon, or a hallucination, or the actual form of some Dark God from the Outer Reaches, come to devour the world. You're not even entirely sure you remember what it looked like. The only thing you can clearly recall is a single name, pulsing in your brain like a bruise:

"Ialdabaoloth".

And that's all.

[Your score has just gone up by five points.]

>take disk
You take the strange black disk.

>look through telescope
The swirling hole in the sky fills the telescope's field of view, turning silently as you watch. The upper depths of the maelstrom are too dark to see, though occasionally you make out sparks of green energy as they arc across the gap.

>look through eyepiece
The swirling hole in the sky fills the telescope's field of view, turning silently as you watch. The upper depths of the maelstrom are too dark to see, though occasionally you make out sparks of green energy as they arc across the gap.

* * *

>x telescope
Constructed of some greenish metal, the telescope consists in the main of an unadorned cylinder about eight inches in diameter, with an eyepiece near the bottom. Near the top, about six inches down from the telescope's upper end, is a thin, rectangular slot, cut horizontally into the side of the cylinder.

>x cylinder
Constructed of some greenish metal, the telescope consists in the main of an unadorned cylinder about eight inches in diameter, with an eyepiece near the bottom. Near the top, about six inches down from the telescope's upper end, is a thin, rectangular slot, cut horizontally into the side of the cylinder.

>x eyepiece
Constructed of some greenish metal, the telescope consists in the main of an unadorned cylinder about eight inches in diameter, with an eyepiece near the bottom. Near the top, about six inches down from the telescope's upper end, is a thin, rectangular slot, cut horizontally into the side of the cylinder.

>search telescope
The swirling hole in the sky fills the telescope's field of view, turning silently as you watch. The upper depths of the maelstrom are too dark to see, though occasionally you make out sparks of green energy as they arc across the gap.

>x slot
It looks as though it might be a receptacle of some kind, perhaps for a special lens.

>put card in slot
You can't see any such thing.

>i
You are carrying:
  a strange black disk
  an old-fashioned iron key
  a small copper key
  a cellar key
  a house key
  your umbrella
  your keyring
  your clothes (being worn)
  your trenchcoat (being worn)
  your wedding ring (being worn)

>put house key in slot
You put the house key into the slot.

>take house key
You take the house key.

* * *

>showme safe
safe - closed container
    dial (part of safe)
location: in Library
unlit, inedible, portable; opaque, closed, unopenable, unlocked; singular-named, improper-named
description: "It's a stark cube of black, oily steel, fifteen inches to a side. Its only feature is large calibrated dial set into the front."
initial appearance: "A section of the shelves in the western wall has slid to one side, revealing a hidden safe."
printing: "blank"
carrying capacity: 100
printed name: "safe"
printed plural name: "containers"
indefinite article: none
list grouping key: none
stage: 0
m3: 22
m2: 12
m1: 34

>turn dial to 34
The tumblers tick quietly as you turn the dial to 34...

>showme safe
safe - closed container
    dial (part of safe)
location: in Library
unlit, inedible, portable; opaque, closed, unopenable, unlocked; singular-named, improper-named
description: "It's a stark cube of black, oily steel, fifteen inches to a side. Its only feature is large calibrated dial set into the front."
initial appearance: "A section of the shelves in the western wall has slid to one side, revealing a hidden safe."
printing: "blank"
carrying capacity: 100
printed name: "safe"
printed plural name: "containers"
indefinite article: none
list grouping key: none
stage: 0
m3: 22
m2: 12
m1: 34

>showme dial
dial - thing
location: part of the safe in Library
unlit, inedible, portable; singular-named, improper-named
description: "The dial is calibrated from one to sixty. It is currently set to 34."
initial appearance: none
printing: "blank"
printed name: "dial"
printed plural name: none
indefinite article: none
list grouping key: none
dvalue: 34

* * *

>close safe
The heavy door swings shut with a metallic clunk.

>solve the safe
The tumblers tick quietly as you turn the dial to 16.

The tumblers tick quietly as you turn the dial to 27.

The tumblers tick quietly as you turn the dial to 13.

>l
Library
Whatever else their faults may have been, the Verlacs were evidently not ones to shun the printed word. Books line the walls from floor to ceiling in this dark-paneled, green-carpeted room, interrupted only by doorways to the east and south. A rich, brown leather armchair sits in stately repose near the window, with a polished brass pipe stand nearby completing the picture of some blue-blooded country squire's literary refuge. Once again, you are struck by how easily this place could have been the perfect home.

A beautiful pair of mahogany sliding doors stand closed to the east.

Resting on the pipe stand is a sizable volume decorated with a gilded pentagram on its cover.

You can also see a safe (in which are a puzzle box and a strange metal flute) here.

>close safe
The heavy door swings shut with a metallic clunk.

>l
Library
Whatever else their faults may have been, the Verlacs were evidently not ones to shun the printed word. Books line the walls from floor to ceiling in this dark-paneled, green-carpeted room, interrupted only by doorways to the east and south. A rich, brown leather armchair sits in stately repose near the window, with a polished brass pipe stand nearby completing the picture of some blue-blooded country squire's literary refuge. Once again, you are struck by how easily this place could have been the perfect home.

A beautiful pair of mahogany sliding doors stand closed to the east.

Resting on the pipe stand is a sizable volume decorated with a gilded pentagram on its cover.

You can also see a safe (in which are a puzzle box and a strange metal flute) here.

* * *

>l
Library
Whatever else their faults may have been, the Verlacs were evidently not ones to shun the printed word. Books line the walls from floor to ceiling in this dark-paneled, green-carpeted room, interrupted only by doorways to the east and south. A rich, brown leather armchair sits in stately repose near the window, with a polished brass pipe stand nearby completing the picture of some blue-blooded country squire's literary refuge. Once again, you are struck by how easily this place could have been the perfect home.

A section of the shelves in the western wall has slid to one side, revealing a hidden safe.

A beautiful pair of mahogany sliding doors stand closed to the east.

Resting on the pipe stand is a sizable volume decorated with a gilded pentagram on its cover.

>close safe
The heavy door swings shut with a metallic clunk.

>l
Library
Whatever else their faults may have been, the Verlacs were evidently not ones to shun the printed word. Books line the walls from floor to ceiling in this dark-paneled, green-carpeted room, interrupted only by doorways to the east and south. A rich, brown leather armchair sits in stately repose near the window, with a polished brass pipe stand nearby completing the picture of some blue-blooded country squire's literary refuge. Once again, you are struck by how easily this place could have been the perfect home.

A beautiful pair of mahogany sliding doors stand closed to the east.

Resting on the pipe stand is a sizable volume decorated with a gilded pentagram on its cover.

You can also see a safe (closed) here.

* * *

>x safe
It's a stark cube of black, oily steel, fifteen inches to a side. Its only feature is large calibrated dial set into the frontThe safe stands open.

In the safe are a puzzle box and a strange metal flute.

>l
Library
Whatever else their faults may have been, the Verlacs were evidently not ones to shun the printed word. Books line the walls from floor to ceiling in this dark-paneled, green-carpeted room, interrupted only by doorways to the east and south. A rich, brown leather armchair sits in stately repose near the window, with a polished brass pipe stand nearby completing the picture of some blue-blooded country squire's literary refuge. Once again, you are struck by how easily this place could have been the perfect home.

A section of the shelves in the western wall has slid to one side, revealing a hidden safe.

A beautiful pair of mahogany sliding doors stand closed to the east.

Resting on the pipe stand is a sizable volume decorated with a gilded pentagram on its cover.

I beg your pardon?

>w
You can't go that way.

>s
Upstairs Hall
The shuttered window at the end of the hall throws a gloomy rectangle of light onto the bare wooden floor. Doorways lead north and south.

There is a cord dangling in mid-air here, right about level with your face.

* * *

>w
Upstairs Landing
A narrow hallway runs east, from the top of the stairs down the length of the house. To the north, directly opposite the stairs, is the master bedroom.

>test study
(Testing.)

>[1] e

Upstairs Hall
The shuttered window at the end of the hall throws a gloomy rectangle of light onto the bare wooden floor. Doorways lead north and south.

There is a cord dangling in mid-air here, right about level with your face.

>[2] n

Library
Whatever else their faults may have been, the Verlacs were evidently not ones to shun the printed word. Books line the walls from floor to ceiling in this dark-paneled, green-carpeted room, interrupted only by doorways to the east and south. A rich, brown leather armchair sits in stately repose near the window, with a polished brass pipe stand nearby completing the picture of some blue-blooded country squire's literary refuge. Once again, you are struck by how easily this place could have been the perfect home.

A section of the shelves in the western wall has slid to one side, revealing a hidden safe.

A beautiful pair of mahogany sliding doors stand closed to the east.

Resting on the pipe stand is a sizable volume decorated with a gilded pentagram on its cover.

>[3] x chair
It's the kind of furniture that you always drool over in catalogs, and it looks about as comfortable as an armchair ever gets without an added shot of heroin.

>[4] x stand
It's a beautiful piece of work, although at the moment, sadly, it contains no pipe.

On the pipe stand is The Compleat Manual of Wardes and Seales.

>[5] take book
Taken.

>[6] read book
Essentially, it's a textbook on the theory and practice of magickal wards and seals, mystic symbols inscribed on doors and containers in order to keep people and spirits out -- or in. It's all very deliberately vague and arcane (in addition to being written in medieval French and translated into Middle English, making it nearly impossible to understand), the kind of thing that likely got many a scholar burned at the stake in those days.

You are surprised to find that a page in this old and probably quite valuable book has been folded down, as though to mark the place. The section marked discusses various methods of opening doors that have been sealed with the image of a pagan god. Speaking aloud the deity's true name will usually do the trick, apparently.

>[7] drop book
Dropped.

>[8] x doors
Each door is carved from a single piece of mahogany, and polished to a deep, rich shine. The doors are closed.

>[9] sit on chair
The leather creaks softly as you settle in. It smells strongly of pipe smoke.

>[10] stand
Reluctantly, you do so.

>s
Upstairs Hall
The shuttered window at the end of the hall throws a gloomy rectangle of light onto the bare wooden floor. Doorways lead north and south.

There is a cord dangling in mid-air here, right about level with your face.

>n
Library
Whatever else their faults may have been, the Verlacs were evidently not ones to shun the printed word. Books line the walls from floor to ceiling in this dark-paneled, green-carpeted room, interrupted only by doorways to the east and south. A rich, brown leather armchair sits in stately repose near the window, with a polished brass pipe stand nearby completing the picture of some blue-blooded country squire's literary refuge. Once again, you are struck by how easily this place could have been the perfect home.

A section of the shelves in the western wall has slid to one side, revealing a hidden safe.

A beautiful pair of mahogany sliding doors stand closed to the east.

You can also see The Compleat Manual of Wardes and Seales here.

>take wards
Taken.

* * *

>open safe
There's no handle on the door; it opens when you get the combination right.

>showme safe
safe - closed container
    dial (part of safe)
location: in Library
unlit, inedible, portable; opaque, closed, unopenable, unlocked; singular-named, improper-named
description: "It's a stark cube of black, oily steel, fifteen inches to a side. Its only feature is large calibrated dial set into the front."
initial appearance: "A section of the shelves in the western wall has slid to one side, revealing a hidden safe."
printing: "blank"
carrying capacity: 100
printed name: "safe"
printed plural name: "containers"
indefinite article: none
list grouping key: none
m3: 34
m2: 23
m1: 49

>turn dial to 34
The tumblers tick quietly as you turn the dial to 34...

>turn dial to 23
The tumblers tick quietly as you turn the dial to 23...

>turn dial to 49
The tumblers tick quietly as you turn the dial to 49...

>showme dial
dial - thing
location: part of the safe in Library
unlit, inedible, portable; singular-named, improper-named
description: "The dial is calibrated from one to sixty. It is currently set to 49."
initial appearance: none
printing: "blank"
printed name: "dial"
printed plural name: none
indefinite article: none
list grouping key: none
dvalue: 49
stage: 0

>turn dial to 34
The tumblers tick quietly as you turn the dial to 34...

>showme dial
dial - thing
location: part of the safe in Library
unlit, inedible, portable; singular-named, improper-named
description: "The dial is calibrated from one to sixty. It is currently set to 34."
initial appearance: none
printing: "blank"
printed name: "dial"
printed plural name: none
indefinite article: none
list grouping key: none
dvalue: 34
stage: 0

>turn dial to 49. turn dial to 23. turn dial to 34.
The tumblers tick quietly as you turn the dial to 49...

The tumblers tick quietly as you turn the dial to 23...

The tumblers tick quietly as you turn the dial to 34...

>showme dial
dial - thing
location: part of the safe in Library
unlit, inedible, portable; singular-named, improper-named
description: "The dial is calibrated from one to sixty. It is currently set to 34."
initial appearance: none
printing: "blank"
printed name: "dial"
printed plural name: none
indefinite article: none
list grouping key: none
dvalue: 34
stage: 0

* * *

>showme safe
safe - closed container
    dial (part of safe)
    puzzle box
    flute
location: in Library
unlit, inedible, portable; opaque, closed, unopenable, unlocked; singular-named, improper-named
description: "It's a stark cube of black, oily steel, fifteen inches to a side. Its only feature is large calibrated dial set into the front."
initial appearance: "A section of the shelves in the western wall has slid to one side, revealing a hidden safe."
printing: "blank"
carrying capacity: 100
printed name: "safe"
printed plural name: "containers"
indefinite article: none
list grouping key: none
stage: 0
m3: 39
m2: 3
m1: 31

>turn dial to 10.
The tumblers tick quietly as you turn the dial to 10...

>showme safe
safe - closed container
    dial (part of safe)
location: in Library
unlit, inedible, portable; opaque, closed, unopenable, unlocked; singular-named, improper-named
description: "It's a stark cube of black, oily steel, fifteen inches to a side. Its only feature is large calibrated dial set into the front."
initial appearance: "A section of the shelves in the western wall has slid to one side, revealing a hidden safe."
printing: "blank"
carrying capacity: 100
printed name: "safe"
printed plural name: "containers"
indefinite article: none
list grouping key: none
stage: 0
m3: 13
m2: 34
m1: 10

>turn dial to 10.
The tumblers tick quietly as you turn the dial to 10...

>showme safe
safe - closed container
    dial (part of safe)
location: in Library
unlit, inedible, portable; opaque, closed, unopenable, unlocked; singular-named, improper-named
description: "It's a stark cube of black, oily steel, fifteen inches to a side. Its only feature is large calibrated dial set into the front."
initial appearance: "A section of the shelves in the western wall has slid to one side, revealing a hidden safe."
printing: "blank"
carrying capacity: 100
printed name: "safe"
printed plural name: "containers"
indefinite article: none
list grouping key: none
stage: 1
m3: 13
m2: 34
m1: 10

>turn dial to 34
The tumblers tick quietly as you turn the dial to 34...

>showme safe
safe - closed container
    dial (part of safe)
location: in Library
unlit, inedible, portable; opaque, closed, unopenable, unlocked; singular-named, improper-named
description: "It's a stark cube of black, oily steel, fifteen inches to a side. Its only feature is large calibrated dial set into the front."
initial appearance: "A section of the shelves in the western wall has slid to one side, revealing a hidden safe."
printing: "blank"
carrying capacity: 100
printed name: "safe"
printed plural name: "containers"
indefinite article: none
list grouping key: none
stage: 2
m3: 13
m2: 34
m1: 10

>turn dial to 13
The tumblers tick quietly as you turn the dial to 13...
and with a hollow thunk, the safe suddenly swings open.

[Your score has just gone up by two points.]

>x safe
It's a stark cube of black, oily steel, fifteen inches to a side. Its only feature is large calibrated dial set into the front.

* * *

>turn dial to 31. turn dial to 3. turn dial to 39.
The tumblers tick quietly as you turn the dial to 31.

The tumblers tick quietly as you turn the dial to 3.

The tumblers tick quietly as you turn the dial to 39.

With a hollow thunk, the safe suddenly swings open.

[Your score has just gone up by two points.]

>x safe
It's a stark cube of black, oily steel, fifteen inches to a side. Its only feature is large calibrated dial set into the front

The safe is currently open. The safe contains puzzle box and flute.

In the safe are a puzzle box and a flute.

* * *

>turn dial to 53
The tumblers tick quietly as you turn the dial to 53.

>turn dial to 45
The tumblers tick quietly as you turn the dial to 45.

>turn dial to 21
The tumblers tick quietly as you turn the dial to 21.

With a hollow thunk, the safe suddenly swings open.

[Your score has just gone up by two points.]

>x safe
It's a stark cube of black, oily steel, fifteen inches to a side. Its only feature is large calibrated dial set into the front.

>look in safe
You can't see inside, since the safe is closed.

* * *

>turn dial to 6
The tumblers tick quietly as you turn the dial to 6...
click!

* * *

>spin dial to 30
The tumblers tick quietly as you turn the dial to 30...

>showme safe
safe - locked container
    dial (part of safe)
location: in Library
unlit, inedible, portable; opaque, closed, openable, lockable, locked; singular-named, improper-named
description: "It's a stark cube of black, oily steel, fifteen inches to a side. Its only feature is large calibrated dial set into the front."
initial appearance: "A section of the shelves in the western wall has slid to one side, revealing a hidden safe."
printing: "blank"
carrying capacity: 100
printed name: "safe"
printed plural name: "containers"
indefinite article: none
list grouping key: none
m1: 21
m2: 1
m3: 39

>turn dial to 21
click!

* * *

>x dial
The dial is calibrated from one to sixty. It is currently set to 10.

>spin dial to 9
The tumblers tick quietly as you turn the dial to 9...

>x dial
The dial is calibrated from one to sixty. It is currently set to 9.

* * *

>x safe
It's a stark cube of black, oily steel, fifteen inches to a side. Its only feature is large calibrated dial set into the front.

In the safe are a puzzle box and a strange metal flute.

>close it
The heavy door swings shut with a metallic clunk.

>close safe
It isn't something you can close.

* * *

>close it
The heavy door swings shut with a metallic clunk.

>l
Library
Whatever else their faults may have been, the Verlacs were evidently not ones to shun the printed word. Books line the walls from floor to ceiling in this dark-paneled, green-carpeted room, interrupted only by doorways to the east and south. A rich, brown leather armchair sits in stately repose near the window, with a polished brass pipe stand nearby completing the picture of some blue-blooded country squire's literary refuge. Once again, you are struck by how easily this place could have been the perfect home.

A beautiful pair of mahogany sliding doors stand closed to the east.

Resting on the pipe stand is a sizable volume decorated with a gilded pentagram on its cover.

You can also see a safe (closed) here.

>x safe
It's a stark cube of black, oily steel, fifteen inches to a side. Its only feature is large calibrated dial set into the frontThe safe stands open.

In the safe are a puzzle box and a strange metal flute.

* * *

>x safe
It's a stark cube of black, oily steel, fifteen inches to a side. Its only feature is large calibrated dial set into the front.

In the safe are a puzzle box and a strange metal flute.

>l
Library
Whatever else their faults may have been, the Verlacs were evidently not ones to shun the printed word. Books line the walls from floor to ceiling in this dark-paneled, green-carpeted room, interrupted only by doorways to the east and south. A rich, brown leather armchair sits in stately repose near the window, with a polished brass pipe stand nearby completing the picture of some blue-blooded country squire's literary refuge. Once again, you are struck by how easily this place could have been the perfect home.

A beautiful pair of mahogany sliding doors stand closed to the east.

Resting on the pipe stand is a sizable volume decorated with a gilded pentagram on its cover.

You can also see a safe (in which are a puzzle box and a strange metal flute) here.

* * *

The oldest and strongest emotion of mankind
is fear, and the oldest and strongest kind of
fear is fear of the unknown.

-- H.P. Lovecraft
                                                                                                                                                                                                                                                  I N F O R M H E A D

Please press SPACE to continue.

>test scratch
>--> The following tests are available:
'test mreads'
'test mfollows'
'test msleeps'
'test day1'
'test cans'
'test window'
'test fence'
'test machine'
'test cabinet'
'test cup'
'test door'
'test streets'
'test lantern'
'test flask'
'test pubdeets'
'test library'
'test register'
'test bell'
'test fetchem'
'test mattress'
'test tin'
'test nastymist'
'test goodmist'
'test notice'
'test hatch'
'test spur'

>test hatch
(Testing.)

>[1] w

Narrow Street
As the lane winds along from east to west, it narrows until the steep, jagged rooftops on either side of the street practically touch each other. To the south, a side street leads across Whateley Bridge toward the center of town, and a twisting lane leads up a hill to the northwest. A short flight of steps to the north leads down to the local watering hole.

>[2] w

Junction
To the north, a gap in the crowded press of gloomy buildings opens onto a country lane, heading out over a grassy heath. The main street continues to the east, while to the northwest, over the top of a steep rise, you can just make out the vaulted rooftops of the university.

>[3] n

Mill Road
The road carries you across a desolate heath of gray, windswept grass. To the south, the black, jagged outline of Anchorhead's steep roofs and sharp, leaning gables cuts across the horizon. The road forks here to the west and east, heading across the railroad tracks in one direction, out toward the seashore in the other.

>[4] w
As you cross the railroad tracks, the air becomes warmer, more dingy, and slightly more difficult to breathe.

Entrance to the Paper Mill
The road turns southwest here and runs squarely through the front entrance to the old paper mill. A gate of heavy iron bars blocks the only opening into this charred fortress, although an overgrown path leads around the wall to the south. To the north, a rutted lane threads its way past a row of dilapidated shacks.

>[5] nw
The road goes north and east from here. The mill gate lies southwest, and an overgrown trail leads south.

>[6] s
The path curves southwest, leading you into an overgrown area behind the mill.

Bare Foundations
The foundations of an older structure lie crumbling in a sunken square of ground, hidden away behind the imposing shadow of the mill wall. Weeds push up through cracked and buckling slabs of concrete; twisted rebar and rusting pipes poke up like the legs of dead insects. The ruins are surrounded on all sides by dense thickets, although narrow, overgrown trails lead northeast and southeast through the underbrush.

>[7] e
The thickets are too dense in that direction.

>[8] search thicket
Carefully pushing the prickly branches aside, you find a rusty metal hatch set into the base of the wall.

>[9] l
Bare Foundations
The foundations of an older structure lie crumbling in a sunken square of ground, hidden away behind the imposing shadow of the mill wall. Weeds push up through cracked and buckling slabs of concrete; twisted rebar and rusting pipes poke up like the legs of dead insects. The ruins are surrounded on all sides by dense thickets, although narrow, overgrown trails lead northeast and southeast through the underbrush.

Set into the base of the mill wall, nearly covered by the thickets, is a metal hatch.

>n
(first opening the hatch)

TODO
Set into the base of the mill wall, nearly covered by the thickets, is a metal hatch.

>s
Bare Foundations
The foundations of an older structure lie crumbling in a sunken square of ground, hidden away behind the imposing shadow of the mill wall. Weeds push up through cracked and buckling slabs of concrete; twisted rebar and rusting pipes poke up like the legs of dead insects. The ruins are surrounded on all sides by dense thickets, although narrow, overgrown trails lead northeast and southeast through the underbrush.

Set into the base of the mill wall, nearly covered by the thickets, is a metal hatch.

>d
The thickets are too dense in that direction.

>n
TODO
Set into the base of the mill wall, nearly covered by the thickets, is a metal hatch.

>s
Bare Foundations
The foundations of an older structure lie crumbling in a sunken square of ground, hidden away behind the imposing shadow of the mill wall. Weeds push up through cracked and buckling slabs of concrete; twisted rebar and rusting pipes poke up like the legs of dead insects. The ruins are surrounded on all sides by dense thickets, although narrow, overgrown trails lead northeast and southeast through the underbrush.

Set into the base of the mill wall, nearly covered by the thickets, is a metal hatch.

>restore
Restore failed.

* * *

>yes
Informhead
An Interactive Fiction by Ed Peters
Release 1 / Serial number 230519 / Inform 7 v10.1.2 / D

Outside the Real Estate Office
A grim little cul-de-sac, tucked away in a corner of the claustrophobic tangle of narrow, twisting avenues that largely constitute the older portion of Anchorhead. Like most of the streets in this city, it is ancient, shadowy, and leads essentially nowhere. The lane ends here at the real estate agent's office, which lies to the east, and winds its way back toward the center of town to the west. A narrow, garbage-choked alley opens to the southeast.

>w. w. n. w. s.
Narrow Street
As the lane winds along from east to west, it narrows until the steep, jagged rooftops on either side of the street practically touch each other. To the south, a side street leads across Whateley Bridge toward the center of town, and a twisting lane leads up a hill to the northwest. A short flight of steps to the north leads down to the local watering hole.

Junction
To the north, a gap in the crowded press of gloomy buildings opens onto a country lane, heading out over a grassy heath. The main street continues to the east, while to the northwest, over the top of a steep rise, you can just make out the vaulted rooftops of the university.

Mill Road
The road carries you across a desolate heath of gray, windswept grass. To the south, the black, jagged outline of Anchorhead's steep roofs and sharp, leaning gables cuts across the horizon. The road forks here to the west and east, heading across the railroad tracks in one direction, out toward the seashore in the other.

As you cross the railroad tracks, the air becomes warmer, more dingy, and slightly more difficult to breathe.

Entrance to the Paper Mill
The road turns southwest here and runs squarely through the front entrance to the old paper mill. A gate of heavy iron bars blocks the only opening into this charred fortress, although an overgrown path leads around the wall to the south. To the north, a rutted lane threads its way past a row of dilapidated shacks.

The path curves southwest, leading you into an overgrown area behind the mill.

Bare Foundations
The foundations of an older structure lie crumbling in a sunken square of ground, hidden away behind the imposing shadow of the mill wall. Weeds push up through cracked and buckling slabs of concrete; twisted rebar and rusting pipes poke up like the legs of dead insects. The ruins are surrounded on all sides by dense thickets, although narrow, overgrown trails lead northeast and southeast through the underbrush.

>n
(first opening the hatch)

TODO

>s
Bare Foundations
The foundations of an older structure lie crumbling in a sunken square of ground, hidden away behind the imposing shadow of the mill wall. Weeds push up through cracked and buckling slabs of concrete; twisted rebar and rusting pipes poke up like the legs of dead insects. The ruins are surrounded on all sides by dense thickets, although narrow, overgrown trails lead northeast and southeast through the underbrush.

* * *

The oldest and strongest emotion of mankind
is fear, and the oldest and strongest kind of
fear is fear of the unknown.

-- H.P. Lovecraft
                                                                                                                                                                                                                                                  I N F O R M H E A D

Please press SPACE to continue.

>test sleep
>--> The following tests are available:
'test mreads'
'test mfollows'
'test msleeps'
'test day1'
'test window'
'test fence'
'test machine'
'test cabinet'
'test cup'
'test door'
'test streets'
'test lantern'
'test flask'
'test pubdeets'
'test library'
'test register'
'test bell'
'test fetchem'
'test mattress'
'test tin'
'test nastymist'
'test goodmist'
'test notice'
'test hatch'
'test spur'

* * *

>yes
Informhead
An Interactive Fiction by Ed Peters
Release 1 / Serial number 230519 / Inform 7 v10.1.2 / D

Outside the Real Estate Office
A grim little cul-de-sac, tucked away in a corner of the claustrophobic tangle of narrow, twisting avenues that largely constitute the older portion of Anchorhead. Like most of the streets in this city, it is ancient, shadowy, and leads essentially nowhere. The lane ends here at the real estate agent's office, which lies to the east, and winds its way back toward the center of town to the west. A narrow, garbage-choked alley opens to the southeast.

>test fetchem
(Testing.)

>[1] se

Alley
This narrow aperture between two buildings is nearly blocked with piles of rotting cardboard boxes and overstuffed garbage cans. Ugly, half-crumbling brick walls to either side totter oppressively over you. The alley ends here at a tall, wooden fence.

High up on the wall of the northern building there is a narrow, transom-style window. 

>[2] push cans to window
Grunting and holding your breath, you manhandle one of the filthy cans under the window.

>[3] stand on cans
You clamber onto the wobbling garbage can, precariously balanced. You can just reach the lower edge of the window from here.

>[4] open window
(the window)
You can't; the window is painted shut.

>[5] enter window
(the window)
(first getting off the cans)
(first opening the window)
The window is too high.

>[6] consult cabinet about verlac
You can't see any such thing.

>[7] w
You can only exit the alley to the northwest. With those cans in place, you might also be able to give the window a try.

>[8] unlock door
You can't see any such thing.

>[9] w
You can only exit the alley to the northwest. With those cans in place, you might also be able to give the window a try.

>[10] w
You can only exit the alley to the northwest. With those cans in place, you might also be able to give the window a try.

>[11] w
You can only exit the alley to the northwest. With those cans in place, you might also be able to give the window a try.

>[12] nw

Outside the Real Estate Office
A grim little cul-de-sac, tucked away in a corner of the claustrophobic tangle of narrow, twisting avenues that largely constitute the older portion of Anchorhead. Like most of the streets in this city, it is ancient, shadowy, and leads essentially nowhere. The lane ends here at the real estate agent's office, which lies to the east, and winds its way back toward the center of town to the west. A narrow, garbage-choked alley opens to the southeast.

>[13] w

Narrow Street
As the lane winds along from east to west, it narrows until the steep, jagged rooftops on either side of the street practically touch each other. To the south, a side street leads across Whateley Bridge toward the center of town, and a twisting lane leads up a hill to the northwest. A short flight of steps to the north leads down to the local watering hole.

>[14] say hello to michael
You can't see any such thing.

>[15] show house key to michael
You can't see any such thing.

* * *

The oldest and strongest emotion of mankind
is fear, and the oldest and strongest kind of
fear is fear of the unknown.

-- H.P. Lovecraft
                                                                                                                                                                                                                                                  I N F O R M H E A D

Please press SPACE to continue.

>test study
>--> The following tests are available:
'test mreads'
'test mfollows'
'test msleeps'
'test day1'
'test betray'
'test window'
'test fence'
'test machine'
'test cabinet'
'test cup'
'test door'
'test streets'
'test lantern'
'test flask'
'test pubdeets'
'test library'
'test register'
'test bell'
'test fetchem'
'test hatch'
'test spur'
'test man'
'test mattress'
'test tin'
'test nastymist'
'test goodmist'
'test notice'
'test obs'
'test crypt'
'test hlib'
'test locket'
'test pages'
'test safe'
'test sitting'
'test gallery'
'test dining'
'test kitchen'

>put keyring on stand
It just doesn't feel right to put that there.

>l
Library
Whatever else their faults may have been, the Verlacs were evidently not ones to shun the printed word. Books line the walls from floor to ceiling in this dark-paneled, green-carpeted room, interrupted only by doorways to the east and south. A rich, brown leather armchair sits in stately repose near the window, with a polished brass pipe stand nearby completing the picture of some blue-blooded country squire's literary refuge. Once again, you are struck by how easily this place could have been the perfect home.

A beautiful pair of mahogany sliding doors stand closed to the east.

On the pipe stand is a keyring (empty).

You can also see The Compleat Manual of Wardes and Seales here.

>take keyring
Taken.

* * *

>put keyring on stand
It just doesn't feel right to put that there.

>take book
Taken.

>put book on stand
You put The Compleat Manual of Wardes and Seales on the pipe stand.

>l
Library
Whatever else their faults may have been, the Verlacs were evidently not ones to shun the printed word. Books line the walls from floor to ceiling in this dark-paneled, green-carpeted room, interrupted only by doorways to the east and south. A rich, brown leather armchair sits in stately repose near the window, with a polished brass pipe stand nearby completing the picture of some blue-blooded country squire's literary refuge. Once again, you are struck by how easily this place could have been the perfect home.

A beautiful pair of mahogany sliding doors stand closed to the east.

On the pipe stand is The Compleat Manual of Wardes and Seales.

>enter armchair
That's not something you can enter.

>sit on armchair
That's not something you can sit down on.

>stand on armchair
That's not something you can stand on.

* * *

>test study
>--> The following tests are available:
'test mreads'
'test mfollows'
'test msleeps'
'test day1'
'test betray'
'test window'
'test fence'
'test machine'
'test cabinet'
'test cup'
'test door'
'test streets'
'test lantern'
'test flask'
'test pubdeets'
'test library'
'test register'
'test bell'
'test fetchem'
'test hatch'
'test spur'
'test man'
'test mattress'
'test tin'
'test nastymist'
'test goodmist'
'test notice'
'test obs'
'test crypt'
'test hlib'
'test locket'
'test pages'
'test safe'
'test sitting'
'test gallery'
'test dining'
'test kitchen'

>sw
(first opening the secret fireplace)
(first unlocking the secret fireplace)
You lack a key that fits the secret fireplace.

* * *

>test study
>--> The following tests are available:
'test mreads'
'test mfollows'
'test msleeps'
'test day1'
'test betray'
'test window'
'test fence'
'test machine'
'test cabinet'
'test cup'
'test door'
'test streets'
'test lantern'
'test flask'
'test pubdeets'
'test library'
'test register'
'test bell'
'test fetchem'
'test hatch'
'test spur'
'test man'
'test mattress'
'test tin'
'test nastymist'
'test goodmist'
'test notice'
'test obs'
'test crypt'
'test hlib'
'test locket'
'test pages'
'test safe'
'test sitting'
'test gallery'
'test dining'
'test kitchen'

>take book
Taken.

>put keyring on stand
It just doesn't feel right to put that there.

* * *

>l
Library
Whatever else their faults may have been, the Verlacs were evidently not ones to shun the printed word. Books line the walls from floor to ceiling in this dark-paneled, green-carpeted room, interrupted only by doorways to the east and south. A rich, brown leather armchair sits in stately repose near the window, with a polished brass pipe stand nearby completing the picture of some blue-blooded country squire's literary refuge. Once again, you are struck by how easily this place could have been the perfect home.

A beautiful pair of mahogany sliding doors stand closed to the east.

* * *

>test study
>--> The following tests are available:
'test mreads'
'test mfollows'
'test msleeps'
'test day1'
'test betray'
'test window'
'test fence'
'test machine'
'test cabinet'
'test cup'
'test door'
'test streets'
'test lantern'
'test flask'
'test pubdeets'
'test library'
'test register'
'test bell'
'test fetchem'
'test hatch'
'test spur'
'test man'
'test mattress'
'test tin'
'test nastymist'
'test goodmist'
'test notice'
'test obs'
'test crypt'
'test hlib'
'test locket'
'test pages'
'test safe'
'test sitting'
'test gallery'
'test dining'
'test kitchen'

>turn spheres
The sphere twists clockwise a few degrees, there is a barely audible "click", and the sphere snaps back into its original position. Suddenly, the entire fireplace slides about eighteen inches to the left with a hollow grinding sound, revealing a narrow corridor in the southwest wall.

>l
Study
This smaller room adjoining the library seems comfortable enough, although it is dusty and cluttered from having not been lived in for the better part of a year. Aside from the desk and the chair and the empty shelves, the only real feature of the room is the large, ornate fireplace in the southern wall.

A dark, narrow corridor gapes in the wall to the soutwest, partially hidden by the marble fireplace.

A beautiful pair of mahogany sliding doors stand open to the west.

On Michael's desk are a letter opener and a laptop.

>sw
Narrow Corridor
The walls are bare wooden slats, patched with crumbling plaster and spiked with bent, rusted nails. The passage, no more than two feet wide at its widest point, bends and twist at confusing angles, making it hard to tell which direction you're heading in.

>ne
Study
This smaller room adjoining the library seems comfortable enough, although it is dusty and cluttered from having not been lived in for the better part of a year. Aside from the desk and the chair and the empty shelves, the only real feature of the room is the large, ornate fireplace in the southern wall.

A dark, narrow corridor gapes in the wall to the soutwest, partially hidden by the marble fireplace.

A beautiful pair of mahogany sliding doors stand open to the west.

On Michael's desk are a letter opener and a laptop.

>turn spheres
The sphere twists clockwise a few degrees, there is a barely audible "click", and the sphere snaps back into its original position. The fireplace grinds back into place, concealing the corridor.

>sw
You can't go that way.

* * *

>turn spheres
The sphere twists clockwise a few degrees, there is a barely audible "click", and the sphere snaps back into its original position. Suddenly, the entire fireplace slides about eighteen inches to the left with a hollow grinding sound, revealing a narrow corridor in the southwest wall.

>sw
Narrow Corridor 1
The walls are bare wooden slats, patched with crumbling plaster and spiked with bent, rusted nails. The passage, no more than two feet wide at its widest point, bends and twist at confusing angles, making it hard to tell which direction you're heading in.

>nw
Study
This smaller room adjoining the library seems comfortable enough, although it is dusty and cluttered from having not been lived in for the better part of a year. Aside from the desk and the chair and the empty shelves, the only real feature of the room is the large, ornate fireplace in the southern wall.

A dark, narrow corridor gapes in the wall to the soutwest, partially hidden by the marble fireplace.

A beautiful pair of mahogany sliding doors stand open to the west.

On Michael's desk are a letter opener and a laptop.

>sw
Narrow Corridor 1
The walls are bare wooden slats, patched with crumbling plaster and spiked with bent, rusted nails. The passage, no more than two feet wide at its widest point, bends and twist at confusing angles, making it hard to tell which direction you're heading in.

>ne. s. e. s.
Narrow Corridor 4
The walls are bare wooden slats, patched with crumbling plaster and spiked with bent, rusted nails. The passage, no more than two feet wide at its widest point, bends and twist at confusing angles, making it hard to tell which direction you're heading in.

Narrow Corridor 2
The walls are bare wooden slats, patched with crumbling plaster and spiked with bent, rusted nails. The passage, no more than two feet wide at its widest point, bends and twist at confusing angles, making it hard to tell which direction you're heading in.

Narrow Corridor 3
The walls are bare wooden slats, patched with crumbling plaster and spiked with bent, rusted nails. The passage, no more than two feet wide at its widest point, bends and twist at confusing angles, making it hard to tell which direction you're heading in.

Narrow Corridor 1
The walls are bare wooden slats, patched with crumbling plaster and spiked with bent, rusted nails. The passage, no more than two feet wide at its widest point, bends and twist at confusing angles, making it hard to tell which direction you're heading in.

>w. nw. e. nw. s. ne.
Narrow Corridor 2
The walls are bare wooden slats, patched with crumbling plaster and spiked with bent, rusted nails. The passage, no more than two feet wide at its widest point, bends and twist at confusing angles, making it hard to tell which direction you're heading in.

Narrow Corridor 5
The walls are bare wooden slats, patched with crumbling plaster and spiked with bent, rusted nails. The passage, no more than two feet wide at its widest point, bends and twist at confusing angles, making it hard to tell which direction you're heading in.

Narrow Corridor 3
The walls are bare wooden slats, patched with crumbling plaster and spiked with bent, rusted nails. The passage, no more than two feet wide at its widest point, bends and twist at confusing angles, making it hard to tell which direction you're heading in.

Narrow Corridor 4
The walls are bare wooden slats, patched with crumbling plaster and spiked with bent, rusted nails. The passage, no more than two feet wide at its widest point, bends and twist at confusing angles, making it hard to tell which direction you're heading in.

Narrow Corridor 2
The walls are bare wooden slats, patched with crumbling plaster and spiked with bent, rusted nails. The passage, no more than two feet wide at its widest point, bends and twist at confusing angles, making it hard to tell which direction you're heading in.

Narrow Corridor 4
The walls are bare wooden slats, patched with crumbling plaster and spiked with bent, rusted nails. The passage, no more than two feet wide at its widest point, bends and twist at confusing angles, making it hard to tell which direction you're heading in.

>sw. se.
Narrow Corridor 5
The walls are bare wooden slats, patched with crumbling plaster and spiked with bent, rusted nails. The passage, no more than two feet wide at its widest point, bends and twist at confusing angles, making it hard to tell which direction you're heading in.

Observatory
You are in a small, enclosed cupola situated, by the look of the view through the dingy skylight over your head, on top of the roof of the house. The walls are covered with astrological and astronomical charts with equations and diagrams scribbled across them in crabbed, stilted handwriting. The only exit seems to be an oddly-angled corridor to the southeast.

* * *

>test study
>--> The following tests are available:
'test mreads'
'test mfollows'
'test msleeps'
'test day1'
'test betray'
'test window'
'test fence'
'test machine'
'test cabinet'
'test cup'
'test door'
'test streets'
'test lantern'
'test flask'
'test pubdeets'
'test library'
'test register'
'test bell'
'test fetchem'
'test hatch'
'test spur'
'test man'
'test mattress'
'test tin'
'test nastymist'
'test goodmist'
'test notice'
'test obs'
'test crypt'
'test hlib'
'test locket'
'test pages'
'test safe'
'test sitting'
'test gallery'
'test dining'
'test kitchen'

>x fireplace
The fireplace is carved from beautiful, dark-veined marble, a strange shade that is not quite a deep, forest green and not quite a murky, dusky red. The mantelpiece is flanked by a pair of polished brass spheres.

>x fire
You can't see any such thing.

>x spheres
You see the room behind you in distorted miniature, and your own face swelling and stretching comically as you peer into the sphere's reflective surface.

Looking closely, you notice some smudges on the otherwise immaculately polished brass.

>turn spheres
The sphere twists clockwise a few degrees, there is a barely audible "click", and the sphere snaps back into its original position. Suddenly, the entire fireplace slides about eighteen inches to the left with a hollow grinding sound, revealing a narrow corridor in the southwest wall.

* * *

>l
Study
This smaller room adjoining the library seems comfortable enough, although it is dusty and cluttered from having not been lived in for the better part of a year. Aside from the desk and the chair and the empty shelves, the only real feature of the room is the large, ornate fireplace in the southern wall.

A dark, narrow corridor gapes in the wall to the soutwest, partially hidden by the marble fireplace.

A beautiful pair of mahogany sliding doors stand open to the west.

On Michael's desk are a letter opener and a laptop.

>x fireplace
The fireplace is carved from beautiful, dark-veined marble, a strange shade that is not quite a deep, forest green and not quite a murky, dusky red. The mantelpiece is flanked by a pair of polished brass spheres.

A dark, narrow corridor gapes in the wall to the soutwest, partially hidden by the marble fireplace.

>sw
You can't go that way.

* * *

>test study
>--> The following tests are available:
'test mreads'
'test mfollows'
'test msleeps'
'test day1'
'test betray'
'test window'
'test fence'
'test machine'
'test cabinet'
'test cup'
'test door'
'test streets'
'test lantern'
'test flask'
'test pubdeets'
'test library'
'test register'
'test bell'
'test fetchem'
'test hatch'
'test spur'
'test man'
'test mattress'
'test tin'
'test nastymist'
'test goodmist'
'test notice'
'test obs'
'test crypt'
'test hlib'
'test locket'
'test pages'
'test safe'
'test sitting'
'test gallery'
'test dining'
'test kitchen'

>x laptop
A top-of-the-line model: it's sleek, lightweight and very fast, a real status symbol for the writer who wants to look as though he might stop whatever he's doing at the drop of a hat and suddenly hack out a bestseller. While you have yet to witness Michael do this, he really had been wanting one since before the two of you even met; so, to celebrate his new teaching position, you splurged and bought him one.

The laptop is currently switched on.

>switch it off
Michael might be in the middle of something, and you don't know if he's saved his work. Better not.

>pronouns
At the moment, "it" means the laptop, "him" is unset, "her" is unset and "them" means the mahogany doors.

>read laptop
The computer is in screen-saver mode: blank except for a single window requesting a 4-digit user passcode. Odd; you didn't think Michael ever used the passcode utility.

>read screen
The computer is in screen-saver mode: blank except for a single window requesting a 4-digit user passcode. Odd; you didn't think Michael ever used the passcode utility.

>examine screen
The computer is in screen-saver mode: blank except for a single window requesting a 4-digit user passcode. Odd; you didn't think Michael ever used the passcode utility.

>type wkljqlkwj
The computer beeps at you. "ACCESS DENIED". Frustrated, you wonder what Michael could have set his password to. An important date, maybe?

>type 0628
The computer beeps at you. "ACCESS DENIED". Frustrated, you wonder what Michael could have set his password to. An important date, maybe?

* * *

>x laptop
A top-of-the-line model: it's sleek, lightweight and very fast, a real status symbol for the writer who wants to look as though he might stop whatever he's doing at the drop of a hat and suddenly hack out a bestseller. While you have yet to witness Michael do this, he really had been wanting one since before the two of you even met; so, to celebrate his new teaching position, you splurged and bought him one.

The laptop is currently switched on.

>switch off laptop
Michael might be in the middle of something, and you don't know if he's saved his work. Better not.

>read laptop
The computer is in screen-saver mode: blank except for a single window requesting a 4-digit user passcode. Odd; you didn't think Michael ever used the passcode utility.

>type
That's not a verb I recognise.

* * *

>x laptop
A top-of-the-line model: it's sleek, lightweight and very fast, a real status symbol for the writer who wants to look as though he might stop whatever he's doing at the drop of a hat and suddenly hack out a bestseller. While you have yet to witness Michael do this, he really had been wanting one since before the two of you even met; so, to celebrate his new teaching position, you splurged and bought him one.

The laptop is currently switched on.

>type 0628
The passcode window disappears and the screen suddenly fills with text, apparently the last thing Michael was working on before he got up and left.

[Your score has just gone up by two points.]

>read screen
Michael has evidently been writing something, but it's not a story; it looks more like some kind of journal entry.

I cannot sleep.

Or perhaps I should say: I must not sleep, since I am perfectly capable of sleep -- in fact, lately sleep has come to me more easily, more quickly, and more insidiously than it ever has before. But I don't want to sleep.

I have been hoping that the terrible dreams would prove to be stress-related, that they would fade once the move was behind us and we had finally settled in -- but that has not turned out to be the case. They're stronger than ever. Red-rimmed eyes pursuing me through strange corridors, and the voice -- the whisperer who tells me I am not who I am. The whisperer tells me secrets of this house, secrets of those who lived here -- they are my blood, and he tells me he always returns to his blood. He tells me of secret keys and combinations; I don't know what they open yet but I have an idea -- 

Tomorrow I must go down to the cellar. I must see if the things revealed to me in that terrible book are true.

I know she is worried about me. I want to tell her, but --

The entry ends there, unfinished.

>open drawer
You open desk drawer, revealing a Cryptical Haermoniacon.

>read book
The greater portion of the book is written in an incomprehensible, flowing cipher; however, the margins in several pages are glossed in English. The book appears to contain instructions for traveling to somewhere called "the Domain of Nehilim", and for worshipping or perhaps summoning an entity that dwells there: He Who Is Named Not; nor may that Name be taught among His followers; that Name which may be learned only by gazing upon His Terrible Countenance...

The only specific details involve a ritual used to open a one-way portal into the Womb of Nehilim, allowing the magician to enter or possibly throw some hapless soul into its chaotic, blasphemous depths. The ritual seems to have something to do with music, and requires the magician to "Attune ye Pillars to ye Resonant Haermonicae", whatever that means.

The rest, by only the barest contrast, is nothing but pure raving.

>drop it
You haven't got that.

>l
Study
This smaller room adjoining the library seems comfortable enough, although it is dusty and cluttered from having not been lived in for the better part of a year. Aside from the desk and the chair and the empty shelves, the only real feature of the room is the large, ornate fireplace in the southern wall.

A beautiful pair of mahogany sliding doors stand open to the west.

On Michael's desk are a letter opener and a laptop.

* * *

The oldest and strongest emotion of mankind
is fear, and the oldest and strongest kind of
fear is fear of the unknown.

-- H.P. Lovecraft
                                                                                                                                                                                                                                                  I N F O R M H E A D

Please press SPACE to continue.

>test window
(Testing.)

>[1] se

Alley
This narrow aperture between two buildings is nearly blocked with piles of rotting cardboard boxes and overstuffed garbage cans. Ugly, half-crumbling brick walls to either side totter oppressively over you. The alley ends here at a tall, wooden fence.

High up on the wall of the northern building there is a narrow, transom-style window. 

>[2] open window
(the window)
The window is too high.

>[3] look through window
(the window)
The window is too high.

>[4] move cans
You push the garbage cans around aimlessly.

>[5] stand on cans
You clamber onto the wobbling garbage can, precariously balanced.

>[6] look through window
(the window)
The window is too high.

>[7] get off cans
You get off the cans.

Alley
This narrow aperture between two buildings is nearly blocked with piles of rotting cardboard boxes and overstuffed garbage cans. Ugly, half-crumbling brick walls to either side totter oppressively over you. The alley ends here at a tall, wooden fence.

High up on the wall of the northern building there is a narrow, transom-style window. 

>[8] push cans to window
Grunting and holding your breath, you manhandle one of the filthy cans under the window.

>[9] stand on cans
You clamber onto the wobbling garbage can, precariously balanced. You can just reach the lower edge of the window from here.

>[10] look through window
(the window)
Peering in through the foggy glass, you can see what looks like a file room.

>[11] open window
(the window)
You open the window.

>[12] enter window
(the window)
(first getting off the cans)

File Room
Peering through the murk, you can make out the blocky outlines of filing cabinets lining the walls and a doorway to the west. A window high up on the south wall lets in a very faint illumination.

You can hear a fly buzzing around, somewhere in this room.

>[13] w

Office
Pallid gray light trickles in through the drawn blinds. The office is deserted, papers still scattered across the top of the desk. The front door lies west, and the file room lies east.

Sitting on the corner of the paper-strewn desk are a telephone and an answering machine.

Someone seems to have left a cup of coffee sitting out, half-finished and cold.

>[14] x latch
It's a little knob that can be turned to lock or unlock the door. It's currently locked.

>[15] turn latch
You unlock the office door.

>[16] w
(first opening the office door)

Outside the Real Estate Office
A grim little cul-de-sac, tucked away in a corner of the claustrophobic tangle of narrow, twisting avenues that largely constitute the older portion of Anchorhead. Like most of the streets in this city, it is ancient, shadowy, and leads essentially nowhere. The lane ends here at the real estate agent's office, which lies to the east, and winds its way back toward the center of town to the west. A narrow, garbage-choked alley opens to the southeast.

The office door is open.

>e
Office
Pallid gray light trickles in through the drawn blinds. The office is deserted, papers still scattered across the top of the desk. The front door lies west, and the file room lies east.

Sitting on the corner of the paper-strewn desk are a telephone and an answering machine.

The office door is open.

Someone seems to have left a cup of coffee sitting out, half-finished and cold.

>close door
You close the office door.

>unlock it
You lock the office door.

>showme door
(the office door)
office door - locked door
location: in Office
unlit, inedible, fixed in place; closed, openable, lockable, locked; singular-named, improper-named
description: "You can make out the words "tsruhkcarB & nosneB" stenciled across the glass. There is a latch on this side which can be turned to lock or unlock the door."
initial appearance: "The office door is closed."
last turn examined: -2
printing: "blank"
leading-through destination: <routine 249298>
printed name: "office door"
printed plural name: "doors"
indefinite article: none
list grouping key: none

>showme door
(the office door)
office door - locked door
location: in Office
unlit, inedible, fixed in place; closed, openable, lockable, locked; singular-named, improper-named
description: "You can make out the words "tsruhkcarB & nosneB" stenciled across the glass. There is a latch on this side which can be turned to lock or unlock the door."
initial appearance: "The office door is closed."
last turn examined: -2
printing: "blank"
leading-through destination: <routine 249298>
printed name: "office door"
printed plural name: "doors"
indefinite article: none
list grouping key: none

>unlock it
You unlock the office door.

>showme door
(the office door)
office door - closed door
location: in Office
unlit, inedible, fixed in place; closed, openable, lockable, unlocked; singular-named, improper-named
description: "You can make out the words "tsruhkcarB & nosneB" stenciled across the glass. There is a latch on this side which can be turned to lock or unlock the door."
initial appearance: "The office door is closed."
last turn examined: -2
printing: "blank"
leading-through destination: <routine 249298>
printed name: "office door"
printed plural name: "doors"
indefinite article: none
list grouping key: none

* * *

>close door
You close the office door.

>lock it
You lock the office door.

>lock it
The door is already locked.

>lock it
The door is already locked.

>unlock it
You unlock the office door.

>unlock it
You lock the office door.

>unlock it
You unlock the office door.

* * *

>lock it
The door is already locked.

>turn latch
You unlock the office door.

>turn latch
You lock the office door.

>unlock office door
You unlock the office door.

>unlock office door
You lock the office door.

>unlock office door
You unlock the office door.

* * *

>lock it
You lock the office door.

>unlock it
You lock the office door.

* * *

>close door
You close the office door.

>unlock it
foo.
bar.
The door is already unlocked.

>lock it
You lock the office door.

>unlock it
foo.
baz.

You unlock the office door.

>unlock it
foo.
bar.
The door is already unlocked.

* * *

>e
File Room
Peering through the murk, you can make out the blocky outlines of filing cabinets lining the walls and a doorway to the west. A window high up on the south wall lets in a very faint illumination.

>consult files about verlac
Strange; the file on the Verlac property has been cleaned out. Title, deed, all the papers, all of it gone. There is, however, a set of keys tucked down in the hanging folder. You quickly pocket them.

[Your score has just gone up by two points.]

>consult cabinet about verlac
Strange; the file on the Verlac property has been cleaned out. Title, deed, all the papers, all of it gone. There is, however, a set of keys tucked down in the hanging folder. You quickly pocket them.

[Your score has just gone up by two points.]

>i
You are carrying:
  a cellar key
  a house key
  your clothes (being worn)
  your trenchcoat (being worn)
  your wedding ring (being worn)
  a keyring

* * *

>consult files about verlac
Strange; the file on the Verlac property has been cleaned out. Title, deed, all the papers, all of it gone. There is, however, a set of keys tucked down in the hanging folder. You quickly pocket them.

[Your score has just gone up by two points.]

>i
You are carrying:
  your clothes (being worn)
  your trenchcoat (being worn)
  your wedding ring (being worn)
  a keyring
    a cellar key
    a house key

>drop house key
You haven't got that.

>take hosue key
You can't see any such thing.

* * *

>drop it
You haven't got that.

>i
You are carrying:
  your clothes (being worn)
  your trenchcoat (being worn)
  your wedding ring (being worn)
  a keyring
    a house key
    a cellar key

* * *

>se. stand on cans. n.
Alley
This narrow aperture between two buildings is nearly blocked with piles of rotting cardboard boxes and overstuffed garbage cans. Ugly, half-crumbling brick walls to either side totter oppressively over you. The alley ends here at a tall, wooden fence.

High up on the wall of the northern building there is a narrow, transom-style window. 

You clamber onto the wobbling garbage can, precariously balanced.

The window is too high.

>push cans toward window
You can't see any such thing.

>push cans to window
You'll have to get down first.

>get down. push cans to window. stand on cans. open window. n.
You must name something more substantial.

You'll have to get down first.

But you're already on the cans.

(the window)
You open the window.

(first getting off the cans)

File Room
Peering through the murk, you can make out the blocky outlines of filing cabinets lining the walls and a doorway to the west. A window high up on the south wall lets in a very faint illumination.

>w.
Office
Pallid gray light trickles in through the drawn blinds. The office is deserted, papers still scattered across the top of the desk. The front door lies west, and the file room lies east.

Sitting on the corner of the paper-strewn desk are a telephone and an answering machine.

Someone seems to have left a cup of coffee sitting out, half-finished and cold.

>turn latch
You unlock the office door.

>w
(first opening the office door)

Outside the Real Estate Office
A grim little cul-de-sac, tucked away in a corner of the claustrophobic tangle of narrow, twisting avenues that largely constitute the older portion of Anchorhead. Like most of the streets in this city, it is ancient, shadowy, and leads essentially nowhere. The lane ends here at the real estate agent's office, which lies to the east, and winds its way back toward the center of town to the west. A narrow, garbage-choked alley opens to the southeast.

The office door is open.

* * *

>test cabinet
(Testing.)

>[1] x cabinet
There must be hundreds of files here, too many to browse through. You'll have to look up something specific if you want to find anything.

>[2] consult cabinet about foo
You don't find anything filed under that foo.

You can hear a fly buzzing around, somewhere in the next room.

>[3] consult cabinet about verlac
Strange; the file on the Verlac property has been cleaned out. Title, deed, all the papers, all of it gone. There is, however, a set of keys tucked down in the hanging folder. You quickly pocket them.

[Your score has just gone up by two points.]

>g
You've already perused that file once.

>g
You've already perused that file once.

>w
Office
Pallid gray light trickles in through the drawn blinds. The office is deserted, papers still scattered across the top of the desk. The front door lies west, and the file room lies east.

Sitting on the corner of the paper-strewn desk are a telephone and an answering machine.

Someone seems to have left a cup of coffee sitting out, half-finished and cold.

>unlock door
You unlock the office door.

>w
(first opening the office door)

Outside the Real Estate Office
A grim little cul-de-sac, tucked away in a corner of the claustrophobic tangle of narrow, twisting avenues that largely constitute the older portion of Anchorhead. Like most of the streets in this city, it is ancient, shadowy, and leads essentially nowhere. The lane ends here at the real estate agent's office, which lies to the east, and winds its way back toward the center of town to the west. A narrow, garbage-choked alley opens to the southeast.

>w
Narrow Street
As the lane winds along from east to west, it narrows until the steep, jagged rooftops on either side of the street practically touch each other. To the south, a side street leads across Whateley Bridge toward the center of town, and a twisting lane leads up a hill to the northwest. A short flight of steps to the north leads down to the local watering hole.

>w
Junction
To the north, a gap in the crowded press of gloomy buildings opens onto a country lane, heading out over a grassy heath. The main street continues to the east, while to the northwest, over the top of a steep rise, you can just make out the vaulted rooftops of the university.

>nw
University Court
Isolated and serene within its high, ivy-covered walls, Miskaton University represents this benighted town's single, if somewhat dubious, claim to cultural achievement. Founded some time in the early 1800s, the school's reputation and enrollment have diminished somewhat as Anchorhead drifts further and further into the abyss of provincial backwaterism. Still, it is generally recognized for its collection of folklore and esoteric mythology (one of the oldest and most extensive on the east coast). The Board of Deans was also kind enough to offer Michael a full professorship upon hearing of his recently discovered heritage and his plans to move into the estate. Ivory tower, perhaps, but at least they take care of their own.

There are numerous buildings surrounding this cobbled court, but the only one you are interested in is the library to the west, where Michael told you he'd be until he came back to the real estate agent's office to pick you up. Which, incidentally, he has not yet done.

>w
Library
Shadows roost thickly in the vaulted ceiling, and small, green-shaded desk lamps cast pools of warm radiance here and there around the library's dim interior. You pause a moment to let the hushed peacefulness of this place soak in -- a welcome relief from the unsettling events of the day. An exit lies east, and a small alcove to the north houses the circulation counter.

Peering through the shadows, you spot your husband sitting at one of the reading desks, absorbed in some sort of weighty tome and clearly oblivious to the time.

Michael turns to a new page in the book and begins reading intently.

>show keys to michael
You can't see any such thing.

>i
You are carrying:
  a cellar key
  a house key

>show house key to michael
Michael is unimpressed.

>say hello to the house key
The house key seems unimpressed.

* * *

>test latch
>--> The following tests are available:
'test mreads'
'test mfollows'
'test msleeps'
'test day1'
'test cans'
'test window'
'test fence'
'test machine'
'test cabinet'
'test cup'
'test door'
'test streets'
'test lantern'
'test flask'
'test pubdeets'
'test library'
'test register'
'test bell'
'test fetchem'
'test mattress'
'test tin'
'test nastymist'
'test goodmist'
'test notice'
'test hatch'
'test spur'

>test day 1.
I only understood you as far as wanting to test that.

* * *

>l
Master Bedroom (on the bed)
The master bedroom is a picture-postcard of rustic New England charm. Faded sketches of rural landscapes adorn the walls; a beautifully carved dressing mirror stands in one corner; an old-fashioned accordion radiator gurgles quietly beneath the window. The most striking feature, an enormous, antique, four-poster bed, must be the largest piece of furniture in the house.

Michael is curled up in bed, sound asleep.

You can also see a keyring, a house key and a cellar key here.

* * *

>unlock door
You should close the door if you're going to lock it.

>e
Office
Pallid gray light trickles in through the drawn blinds. The office is deserted, papers still scattered across the top of the desk. The front door lies west, and the file room lies east.

Sitting on the corner of the paper-strewn desk are a telephone and an answering machine.

The office door is open.

Someone seems to have left a cup of coffee sitting out, half-finished and cold.

* * *

>lock it
You lock the office door.

>lock it
You unlock the office door.

>lock it
You lock the office door.

* * *

The oldest and strongest emotion of mankind
is fear, and the oldest and strongest kind of
fear is fear of the unknown.

-- H.P. Lovecraft
                                                                                                                                                                                                                                                  I N F O R M H E A D

Please press SPACE to continue.

>threein
That's not a verb I recognise.

* * *

The oldest and strongest emotion of mankind
is fear, and the oldest and strongest kind of
fear is fear of the unknown.

-- H.P. Lovecraft
                                                                                                                                                                                                                                                  I N F O R M H E A D

Please press SPACE to continue.

>unlock door
You lack a key that fits the office door.

The rain slackens off momentarily to a weak drizzle, then returns afresh in a brief, freezing downpour.

>lock door
That's locked at the moment.

>x latch
You can't see any such thing.

>test window
(Testing.)

>[1] se

Alley
This narrow aperture between two buildings is nearly blocked with piles of rotting cardboard boxes and overstuffed garbage cans. Ugly, half-crumbling brick walls to either side totter oppressively over you. The alley ends here at a tall, wooden fence.

High up on the wall of the northern building there is a narrow, transom-style window. 

>[2] open window
(the window)
The window is too high.

>[3] look through window
(the window)
The window is too high.

>[4] move cans
You push the garbage cans around aimlessly.

>[5] stand on cans
You clamber onto the wobbling garbage can, precariously balanced.

The clouds overhead mutter restlessly to themselves.

>[6] look through window
(the window)
The window is too high.

>[7] get off cans
You get off the cans.

Alley
This narrow aperture between two buildings is nearly blocked with piles of rotting cardboard boxes and overstuffed garbage cans. Ugly, half-crumbling brick walls to either side totter oppressively over you. The alley ends here at a tall, wooden fence.

High up on the wall of the northern building there is a narrow, transom-style window. 

>[8] push cans to window
Grunting and holding your breath, you manhandle one of the filthy cans under the window.

>[9] stand on cans
You clamber onto the wobbling garbage can, precariously balanced. You can just reach the lower edge of the window from here.

>[10] look through window
(the window)
Peering in through the foggy glass, you can see what looks like a file room.

>[11] open window
(the window)
You open the window.

>[12] enter window
(the window)
(first getting off the cans)

File Room
Peering through the murk, you can make out the blocky outlines of filing cabinets lining the walls and a doorway to the west. A window high up on the south wall lets in a very faint illumination.

>[13] w

Office
Pallid gray light trickles in through the drawn blinds. The office is deserted, papers still scattered across the top of the desk. The front door lies west, and the file room lies east.

Sitting on the corner of the paper-strewn desk are a telephone and an answering machine.

Someone seems to have left a cup of coffee sitting out, half-finished and cold.

>[14] x latch
It's a little knob that can be turned to lock or unlock the door. It's currently locked.

>[15] turn latch
You unlock the office door.

>[16] w
(first opening the office door)

Outside the Real Estate Office
A grim little cul-de-sac, tucked away in a corner of the claustrophobic tangle of narrow, twisting avenues that largely constitute the older portion of Anchorhead. Like most of the streets in this city, it is ancient, shadowy, and leads essentially nowhere. The lane ends here at the real estate agent's office, which lies to the east, and winds its way back toward the center of town to the west. A narrow, garbage-choked alley opens to the southeast.

The office door is open.

>lock office door
(first closing the office door)
You lack a key that fits the office door.

In the distance, you can hear the lonesome keening of a train whistle drifting on the wind.

>e
(first opening the office door)

Office
Pallid gray light trickles in through the drawn blinds. The office is deserted, papers still scattered across the top of the desk. The front door lies west, and the file room lies east.

Sitting on the corner of the paper-strewn desk are a telephone and an answering machine.

The office door is open.

Someone seems to have left a cup of coffee sitting out, half-finished and cold.

>close door
You close the office door.

>lock it
You lack a key that fits the office door.

>unlock it
You lock the office door.

* * *

The oldest and strongest emotion of mankind
is fear, and the oldest and strongest kind of
fear is fear of the unknown.

-- H.P. Lovecraft
                                                                                                                                                                                                                                                  I N F O R M H E A D

Please press SPACE to continue.

>unlock office door
You lack a key that fits the office door.

>lock office door
The office door is already !!! locked.

>showme latch
latch - thing
location: part of the office door in Outside the Real Estate Office
unlit, inedible, portable; singular-named, improper-named
description: "It's a little knob that can be turned to lock or unlock the door. It's currently locked."
initial appearance: none
last turn examined: -2
printing: "blank"
printed name: "latch"
printed plural name: none
indefinite article: none
list grouping key: none

* * *

>unlock office door
You lack a key that fits the office door.

>open office door
You open the office door.

>e
Office
Pallid gray light trickles in through the drawn blinds. The office is deserted, papers still scattered across the top of the desk. The front door lies west, and the file room lies east.

Sitting on the corner of the paper-strewn desk are a telephone and an answering machine.

The office door is open.

Someone seems to have left a cup of coffee sitting out, half-finished and cold.

>w
Outside the Real Estate Office
A grim little cul-de-sac, tucked away in a corner of the claustrophobic tangle of narrow, twisting avenues that largely constitute the older portion of Anchorhead. Like most of the streets in this city, it is ancient, shadowy, and leads essentially nowhere. The lane ends here at the real estate agent's office, which lies to the east, and winds its way back toward the center of town to the west. A narrow, garbage-choked alley opens to the southeast.

The office door is open.

* * *

>e
Office
Pallid gray light trickles in through the drawn blinds. The office is deserted, papers still scattered across the top of the desk. The front door lies west, and the file room lies east.

Sitting on the corner of the paper-strewn desk are a telephone and an answering machine.

The office door is open.

Someone seems to have left a cup of coffee sitting out, half-finished and cold.

>close office door
You close the office door.

>lock it
You lack a key that fits the office door.

* * *

>e
Office
Pallid gray light trickles in through the drawn blinds. The office is deserted, papers still scattered across the top of the desk. The front door lies west, and the file room lies east.

Sitting on the corner of the paper-strewn desk are a telephone and an answering machine.

The office door is open.

Someone seems to have left a cup of coffee sitting out, half-finished and cold.

>lock door
You should close the door if you're going to lock it.

>close door
You close the office door.

* * *

The oldest and strongest emotion of mankind
is fear, and the oldest and strongest kind of
fear is fear of the unknown.

-- H.P. Lovecraft
                                                                                                                                                                                                                                                  I N F O R M H E A D

Please press SPACE to continue.

>version
Informhead
An Interactive Fiction by Ed Peters
Release 1 / Serial number 230523 / Inform 7 v10.1.2 / D
Inform 7 v10.1.2
Identification number: //3AFCE1D7-5D45-4D11-8491-3C14688FF830//
Interpreter version 0.6.0 / VM 3.1.3

* * *

The oldest and strongest emotion of mankind
is fear, and the oldest and strongest kind of
fear is fear of the unknown.

-- H.P. Lovecraft
                                                                                                                                                                                                                                                  I N F O R M H E A D

Please press SPACE to continue.

>w
Narrow Street
As the lane winds along from east to west, it narrows until the steep, jagged rooftops on either side of the street practically touch each other. To the south, a side street leads across Whateley Bridge toward the center of town, and a twisting lane leads up a hill to the northwest. A short flight of steps to the north leads down to the local watering hole.

>nw
Twisting Lane
The lane narrows here to little more than a badly cobbled sidewalk as it wends its way up through a series of tortuous bends and switchbacks. In some places, the street is so steep that steps have been cut into it, worn down over the years and slick with moss. Your progress is blocked at the top of the street by a brick wall.

Someone has sprayed graffiti across the wall in black spray paint.

* * *

>w
Hidden Court
You had no idea this little courtyard even existed, cleverly tucked away amidst the confusing tangle of darker avenues. Although surrounded on all sides by steep rooftops and overshadowed by the ever- ominous clouds, this secluded circle somehow manages to convey a sense of peace and brightness, a safe harbor from the oppressive gloom pervading the rest of the town. To the south, a hanging sign marks a humble shop, while a sidestreet to the east leads back into the labyrinth.

>e
Twisting Lane
The lane narrows here to little more than a badly cobbled sidewalk as it wends its way up through a series of tortuous bends and switchbacks. In some places, the street is so steep that steps have been cut into it, worn down over the years and slick with moss. Your progress is blocked at the top of the street by a blank brick wall.

Someone has sprayed graffiti across the wall in black spray paint.

>x graffiti
It's a strange design done in black spraypaint; an upturned hand with an irregular triangle inscribed in the palm. Beneath it is drawn an arrow pointing roughly west, and following it with your gaze, you realize that it points directly at the narrow aperture of a sidestreet you'd never noticed before.

>w
Hidden Court
You had no idea this little courtyard even existed, cleverly tucked away amidst the confusing tangle of darker avenues. Although surrounded on all sides by steep rooftops and overshadowed by the ever- ominous clouds, this secluded circle somehow manages to convey a sense of peace and brightness, a safe harbor from the oppressive gloom pervading the rest of the town. To the south, a hanging sign marks a humble shop, while a sidestreet to the east leads back into the labyrinth.

>x sign
It simply reads, in gaudily illuminated letters, "The Cauldron".

>s
Cauldron
A warm and pleasantly dim light surrounds you and suffuses this cozy little shop. The shelves are crammed with every conceivable variety of new age curiosity: books, crystals, pendants, charms, herbs, potions, incense, candles and -- sure enough, on a display stand right near the door -- decorative cast-iron cauldron-shaped paperweights. How cute. In the rear of the store, a lit display case contains several items of interest. The courtyard lies outside, to the north.

On the display case is a violin.

You can also see an amulet here.

* * *

>give puzzle box to proprietor
The proprietor takes the puzzle box and turns it over in his hands carefully. "Now, this is a tricky one," he says. "They don't make them like this anymore. Frightfully difficult, unless you know the catch of course." His fingers flicker dexterously over the box, sliding a panel here, pressing a corner in there. Suddenly the lid pops open with a faint snick.

"And there you have it," he says. "A present for you." He hands it back to you.

[Your score has just gone up by two points.]

>i
You are carrying:
  a puzzle box
    a strange black disk
  A Historical Overview of Superstitions by J. Arnsworth Frazer
  your clothes (being worn)
  your trenchcoat (being worn)
  your wedding ring (being worn)
  your umbrella
  your keyring

>x box
It's roughly the size and shape of a cigar box, carved from some dark and oddly streaked wood that you can't identify. All six surfaces are decorated in a complex arrangement of grooves and panels, most of which are illustrated with leering, demonic faces and obscene designs.

In the puzzle box is a strange black disk.

>x disk
It's a dark, glassy circle, about the width of your hand in diameter and half an inch thick in the middle, tapering off to thinness toward the edge like a convex lens. Its color is the deep, oily black of obsidian, though you fancy you can see faint swirls of color inside it like the rainbow sheen of oil on water. Its curved surface is cool and perfectly smooth. Although incredibly hard, the material does not feel like stone; there is an odd, yielding quality to it, almost like something organic... almost, you realize with disquiet, like skin.

>look through disk
You find nothing of interest.

* * *

>give puzzle box to proprietor
The proprietor takes the puzzle box and turns it over in his hands carefully. "Now, this is a tricky one," he says. "They don't make them like this anymore. Frightfully difficult, unless you know the catch of course." His fingers flicker dexterously over the box, sliding a panel here, pressing a corner in there. Suddenly the lid pops open with a faint snick.

"And there you have it," he says. "A present for you." He hands it back to you.

[Your score has just gone up by two points.]

>l
Cauldron
A warm and pleasantly dim light surrounds you and suffuses this cozy little shop. The shelves are crammed with every conceivable variety of new age curiosity: books, crystals, pendants, charms, herbs, potions, incense, candles and -- sure enough, on a display stand right near the door -- decorative cast-iron cauldron-shaped paperweights. How cute. In the rear of the store, a lit display case contains several items of interest. The courtyard lies outside, to the north.

On the display case is a violin.

The proprietor watches you quietly from behind the display case.

>x display case
The display case has a glass front and sliding doors in back that allow the proprietor to reach inside. Lined up inside the case are puzzle box, set of tarot cards, geode and amulet. Resting on top of the case is a violin.

>take puzzle box
You take the puzzle box. It's roughly the size and shape of a cigar box, carved from some dark and oddly streaked wood that you can't identify. All six surfaces are decorated in a complex arrangement of grooves and panels, most of which are illustrated with leering, demonic faces and obscene designs. As far as you can tell, it is in fact a box, and meant to be opened; however, you see no obvious way to do so..

>x it
It's roughly the size and shape of a cigar box, carved from some dark and oddly streaked wood that you can't identify. All six surfaces are decorated in a complex arrangement of grooves and panels, most of which are illustrated with leering, demonic faces and obscene designs. As far as you can tell, it is in fact a box, and meant to be opened; however, you see no obvious way to do so.

In the puzzle box is a strange black disk.

>x disk
It's a dark, glassy circle, about the width of your hand in diameter and half an inch thick in the middle, tapering off to thinness toward the edge like a convex lens. Its color is the deep, oily black of obsidian, though you fancy you can see faint swirls of color inside it like the rainbow sheen of oil on water. Its curved surface is cool and perfectly smooth. Although incredibly hard, the material does not feel like stone; there is an odd, yielding quality to it, almost like something organic... almost, you realize with disquiet, like skin.

* * *

>look through disk
You find nothing of interest.

>take disk
You take the strange black disk.

>look through it
You find nothing of interest.

* * *

>x case
The display case has a glass front and sliding doors in back that allow the proprietor to reach inside. Lined up inside the case are tarot cards and geode. Resting on top of the case is a violin.

* * *

>x paperweights
Mostly a lot of hokey, pseudo-spiritualist knick-knacks. Junk, really. Tourist souvenirs.

>x case
The display case is empty.

* * *

>x tarot
A beautiful set of cards in a velvet-lined box. The top card, "The Tower", has been turned up, allowing you to see the exquisitely detailed artwork. In this representation, the tower has been painted to resemble a lighthouse, broken by a bolt of lightning emanating from a great, red-rimmed eye. Two figures, a man and a woman, tumble from the tower's summit, cast lifelessly into the sea.

>x geode
A hemisphere of rough, gray stone, about the size and shape of a halved cantaloupe. Its center is a glittering cavity of violet crystals, thousands of sparkling, faceted stalactites and stalagmites inside a cave of colored glass.

>x amulet
It's an unassuming silver pendant hanging from a thin leather thong, fashioned in the shape of a tiny, upturned hand with a triangle inscribed within the palm. It reminds you a little of one of those cast pewter game pieces from Monopoly.

* * *

>ask proprietor about the amulet
The proprietor reaches in through the back of the case and takes out the amulet. It spins slowly as he holds it up to the light.

"I think, perhaps, that he eventually found different. And I think, perhaps, that you will, too." He leans forward and, before you can react, slips the leather thong around your neck. "But you won't make the same mistake, will you, Miss? No. You go on and keep that, now. My treat. You may find it useful soon."

(first taking the amulet)
You can't wear that!

[Your score has just gone up by five points.]

>l
Cauldron
A warm and pleasantly dim light surrounds you and suffuses this cozy little shop. The shelves are crammed with every conceivable variety of new age curiosity: books, crystals, pendants, charms, herbs, potions, incense, candles and -- sure enough, on a display stand right near the door -- decorative cast-iron cauldron-shaped paperweights. How cute. In the rear of the store, a lit display case contains several items of interest. The courtyard lies outside, to the north.

On the display case is a violin.

You can also see a proprietor here.

>x case
The display case has a glass front and sliding doors in back that allow the proprietor to reach inside. Lined up inside the case are set of tarot cards and geode. Resting on top of the case is a violin.

* * *

>s
Whateley Bridge
A hoary monument of crumbling, moss-eaten flagstones, Whateley Bridge is possibly older than any other structure in the entire city. Ponderously it spans the dark, torpid waters of the Miskaton River, connecting the north and south halves of the city and occasionally raining bits of gravel and mortar from its underside into the water. It looks just wide enough for two cars to pass each other between the flanking stone parapets, but you wouldn't volunteer to try it.

>e
The bridge only leads north and south from here.

>s
Town Square
A wide expanse of uneven pavestones lies open to the sky, bordered on all sides by the leaning, steep-roofed architecture that looms over everything in this city. The municipal courthouse stands at the south end of the square, next to the mouth of a dark, narrow alley to the southwest. Avenues to the west and east lead back into the cramped and ingrown streets, while to the north lies Whateley Bridge.

In the center of the square, rising from a circular lawn of unhealthy-looking grass and weeds, stands a strange, stone obelisk. It seems to be a monument of some sort, although you can see no plaque or marker anywhere near it.

* * *

>e
Riverwalk
A low, irregular brick wall to the north divides this street from the steep, mud-slick banks of the sinuous Miskaton, while a rusty iron gate provides access to a precarious flight of stone steps leading down the bank to the water's edge. The street bends south here, turning into a misty avenue between the trees. The town square lies west, a vacant lot lies east.

>e
Vacant Lot
Where once a building stood, there is now only cracked pavement and rampant weeds. A high chain-link fence surrounds this vacant lot; the only breaks lie to the west and southeast.

A filthy old mattress lies among the weeds over in one corner of the lot.

>x mattress
The mattress is stained and beaten, oozing stuffing in several places. From the cans and food wrappers scattered around it, it looks as though somebody's been using it as a bed.

>move it
The mattress is extremely dirty and probably infested with bugs. You'd just as soon not even touch it, much less drag it around with you.

* * *

>e
Riverwalk
A low, irregular brick wall to the north divides this street from the steep, mud-slick banks of the sinuous Miskaton, while a rusty iron gate provides access to a precarious flight of stone steps leading down the bank to the water's edge. The street bends south here, turning into a misty avenue between the trees. The town square lies west, a vacant lot lies east.

>n
The street leads to the west and to the south. A vacant lot lies east and a rusty gate lies to the north.

>d
] Under the Bridge
The ponderous stones of Whateley Bridge arch overhead, casting this little concrete ledge into deep shadow. At your feet, the dark waters lap quietly against the stones with a hollow, subterranean sound. Stone steps to the southeast lead back up to street level.

A small metal door, blotchy with rust, is set into the south bank of the river, underneath the bridge.

>x steps
The stairs lead back up to the riverwalk.

>u
Riverwalk
A low, irregular brick wall to the north divides this street from the steep, mud-slick banks of the sinuous Miskaton, while a rusty iron gate provides access to a precarious flight of stone steps leading down the bank to the water's edge. The street bends south here, turning into a misty avenue between the trees. The town square lies west, a vacant lot lies east.

>x steps
The stairs lead down to the banks of the river.

>d
] Under the Bridge
The ponderous stones of Whateley Bridge arch overhead, casting this little concrete ledge into deep shadow. At your feet, the dark waters lap quietly against the stones with a hollow, subterranean sound. Stone steps to the southeast lead back up to street level.

A small metal door, blotchy with rust, is set into the south bank of the river, underneath the bridge.

>se
You can return to the riverwalk by going up the stairs to the southeast, or you can go through the small, rusty door to the south.

* * *

>e
Vacant Lot
Where once a building stood, there is now only cracked pavement and rampant weeds. A high chain-link fence surrounds this vacant lot; the only breaks lie to the west and southeast.

A filthy old mattress lies among the weeds over in one corner of the lot.

>se
Wharf
The gentle creaking of hawsers and the hollow slap of water beneath the wooden pier provide a faint counterpoint to the endless, rhythmic surging of the sea. The fishing industry (like the paper industry) has all but died away in Anchorhead; nonetheless there are still a few boats tied to the pier. A path leads back through an opening in a chain-link fence to the northwest; otherwise, it's just you and the ocean.

An old, discarded tin of fish oil sits at the end of the pier.

>enter boats
The boats are not your property, and you have no desire to trespass on what is probably someone's last feeble source of livelihood.

* * *

>se
Wharf
The gentle creaking of hawsers and the hollow slap of water beneath the wooden pier provide a faint counterpoint to the endless, rhythmic surging of the sea. The fishing industry (like the paper industry) has all but died away in Anchorhead; nonetheless there are still a few boats tied to the pier. A path leads back through an opening in a chain-link fence to the northwest; otherwise, it's just you and the ocean.

An old, discarded tin of fish oil sits at the end of the pier.

>x tin
It's dented and rusty, and you can barely make out the words "Skagen, Denmark" printed along the side. The lid is closed.

>open it
You open the old tin, revealing an a smelly quantity of fish oil.

>x tin
It's dented and rusty, and you can barely make out the words "Skagen, Denmark" printed along the side. The lid is peeled back, revealing a smelly quantity of fish oil..

In the old tin is an a smelly quantity of fish oil.

>x oil
It's a viscous, nasty-smelling goo, made from and made for feeding fish. Not very appetizing.

* * *

>x tin
It's dented and rusty, and you can barely make out the words "Skagen, Denmark" printed along the side. The lid is closed.

>take it
Taken.

>open it
You open the old tin, revealing a fish oil.

* * *

>take it
Taken.

>x it
It's dented and rusty, and you can barely make out the words "Skagen, Denmark" printed along the side. The lid is closed.

>open tin
You open the old tin, revealing an a smelly quantity of fish oil.

>x it
It's dented and rusty, and you can barely make out the words "Skagen, Denmark" printed along the side. The lid is peeled back, revealing a smelly quantity of fish oil.

>x oil
It's a viscous, nasty-smelling goo, made from and made for feeding fish. Not very appetizing.

>search tin
In the old tin is a smelly quantity of fish oil.

>close tin
You close the old tin.

>search tin
You can't see inside, since the old tin is closed.

* * *

>x tin
It's dented and rusty, and you can barely make out the words "Skagen, Denmark" printed along the side. The lid is closed.

>take tin
Taken.

>open it
It isn't something you can open.

* * *

>e
Riverwalk
A low, irregular brick wall to the north divides this street from the steep, mud-slick banks of the sinuous Miskaton, while a rusty iron gate provides access to a precarious flight of stone steps leading down the bank to the water's edge. The street bends south here, turning into a misty avenue between the trees. The town square lies west, a vacant lot lies east.

>s
Chilly Avenue
Perhaps it is merely the effect of some unwholesome vapour rising from the murky waters of the nearby Miskaton, but the temperature along this street seems perceptibly cooler than normal, even for a New England autumn. Two dirt roads lead south and southwest, into the dense woods at the edge of town.

A clammy mist hangs thickly in the air, seeping through your clothes and making you shiver.

>e
The street leads north and south from here, and another road splits off to the southwest.

* * *

>s
Chilly Avenue
Perhaps it is merely the effect of some unwholesome vapour rising from the murky waters of the nearby Miskaton, but the temperature along this street seems perceptibly cooler than normal, even for a New England autumn. Two dirt roads lead south and southwest, into the dense woods at the edge of town.

A clammy mist hangs thickly in the air, seeping through your clothes and making you shiver.

>n
Riverwalk
A low, irregular brick wall to the north divides this street from the steep, mud-slick banks of the sinuous Miskaton, while a rusty iron gate provides access to a precarious flight of stone steps leading down the bank to the water's edge. The street bends south here, turning into a misty avenue between the trees. The town square lies west, a vacant lot lies east.

>s
Chilly Avenue
Perhaps it is merely the effect of some unwholesome vapour rising from the murky waters of the nearby Miskaton, but the temperature along this street seems perceptibly cooler than normal, even for a New England autumn. Two dirt roads lead south and southwest, into the dense woods at the edge of town.

A clammy mist hangs thickly in the air, seeping through your clothes and making you shiver.

>se
The street leads north and south from here, and another road splits off to the southwest.

>sw
The street leads north and south from here, and another road splits off to the southwest.

* * *

>s
Chilly Avenue
Perhaps it is merely the effect of some unwholesome vapour rising from the murky waters of the nearby Miskaton, but the temperature along this street seems perceptibly cooler than normal, even for a New England autumn. Two dirt roads lead south and southwest, into the dense woods at the edge of town.

A clammy mist hangs thickly in the air, seeping through your clothes and making you shiver.

>s
Deserted Lane
The gently winding lane makes its way through the birch woods south of town. New England foliage is famous for its splendid colors in the fall, but the oppressive weather and pervading murk have leached these trees of most of their tint. The road continues south into the increasingly dense forest, and in the other direction heads back to town. A paved walk also leads east through the trees.

>e
You can't go that way.

* * *

>s
Deserted Lane
The gently winding lane makes its way through the birch woods south of town. New England foliage is famous for its splendid colors in the fall, but the oppressive weather and pervading murk have leached these trees of most of their tint. The road continues south into the increasingly dense forest, and in the other direction heads back to town. A paved walk also leads east through the trees.

>n
Chilly Avenue
Perhaps it is merely the effect of some unwholesome vapour rising from the murky waters of the nearby Miskaton, but the temperature along this street seems perceptibly cooler than normal, even for a New England autumn. Two dirt roads lead south and southwest, into the dense woods at the edge of town.

A clammy mist hangs thickly in the air, seeping through your clothes and making you shiver.

>sw
Foo.
Before you can take more than a few steps, the mist coils its tendrils around you, freezing your marrow with its damp embrace. For one terrifying moment you can feel it probing at your mouth and nostrils, seeking a way in, and then with a sudden wrench you are free, gasping and choking and eyeing the mist with newfound wariness.

* * *

>s
Deserted Lane
The gently winding lane makes its way through the birch woods south of town. New England foliage is famous for its splendid colors in the fall, but the oppressive weather and pervading murk have leached these trees of most of their tint. The road continues south into the increasingly dense forest, and in the other direction heads back to town. A paved walk also leads east through the trees.

>s
Down the Road
The forest grows denser as you go, crowding thickly up to either side of the road. The groping, tangled branches block out what little sunlight there is left. Your footsteps are muffled; whispering leaves and the slow drip of water are the only sounds you can hear. Beyond the watching trees, the shadows are impenetrably thick. The road stretches interminably, north to south.

>n
Deserted Lane
The gently winding lane makes its way through the birch woods south of town. New England foliage is famous for its splendid colors in the fall, but the oppressive weather and pervading murk have leached these trees of most of their tint. The road continues south into the increasingly dense forest, and in the other direction heads back to town. A paved walk also leads east through the trees.

>n
Chilly Avenue
Perhaps it is merely the effect of some unwholesome vapour rising from the murky waters of the nearby Miskaton, but the temperature along this street seems perceptibly cooler than normal, even for a New England autumn. Two dirt roads lead south and southwest, into the dense woods at the edge of town.

>sw
The street leads north and south from here, and another road splits off to the southwest.

>e
The street leads north and south from here, and another road splits off to the southwest.

* * *

>s
Deserted Lane
The gently winding lane makes its way through the birch woods south of town. New England foliage is famous for its splendid colors in the fall, but the oppressive weather and pervading murk have leached these trees of most of their tint. The road continues south into the increasingly dense forest, and in the other direction heads back to town. A paved walk also leads east through the trees.

>sw
The street leads north and south from here, and another road splits off to the southwest.

* * *

>e
The street leads north and south from here, and another road splits off to the southwest.

>n
Riverwalk
A low, irregular brick wall to the north divides this street from the steep, mud-slick banks of the sinuous Miskaton, while a rusty iron gate provides access to a precarious flight of stone steps leading down the bank to the water's edge. The street bends south here, turning into a misty avenue between the trees. The town square lies west, a vacant lot lies east.

* * *

>s
Chilly Avenue
Perhaps it is merely the effect of some unwholesome vapour rising from the murky waters of the nearby Miskaton, but the temperature along this street seems perceptibly cooler than normal, even for a New England autumn. Two dirt roads lead south and southwest, into the dense woods at the edge of town.

A clammy mist hangs thickly in the air, seeping through your clothes and making you shiver.

>showme
Chilly Avenue - room
    yourself - person
    clammy mist

>x mist
The mist seems to gather most thickly to the southwest. You can't see more than a few yards down the road in that direction.

>s
You can't go that way.

>sw
You can't go that way.

>n
Riverwalk
A low, irregular brick wall to the north divides this street from the steep, mud-slick banks of the sinuous Miskaton, while a rusty iron gate provides access to a precarious flight of stone steps leading down the bank to the water's edge. The street bends south here, turning into a misty avenue between the trees. The town square lies west, a vacant lot lies east.

>showme
Riverwalk - room
    yourself - person
    steps - backdrop
    old brick wall
    rusty gate

* * *

>s
Chilly Avenue
Perhaps it is merely the effect of some unwholesome vapour rising from the murky waters of the nearby Miskaton, but the temperature along this street seems perceptibly cooler than normal, even for a New England autumn. Two dirt roads lead south and southwest, into the dense woods at the edge of town.

A clammy mist hangs thickly in the air, seeping through your clothes and making you shiver.

>sw
The street leads north and south from here, and another road splits off to the southwest.

>s
The street leads north and south from here, and another road splits off to the southwest.

* * *

>sw
The street leads north and south from here, and another road splits off to the southwest.

>sw
The street leads north and south from here, and another road splits off to the southwest.

* * *

>e
Riverwalk
A low, irregular brick wall to the north divides this street from the steep, mud-slick banks of the sinuous Miskaton, while a rusty iron gate provides access to a precarious flight of stone steps leading down the bank to the water's edge. The street bends south here, turning into a misty avenue between the trees. The town square lies west, a vacant lot lies east.

>x steps
The stairs lead down to the banks of the river.

>d
Under the Bridge
The ponderous stones of Whateley Bridge arch overhead, casting this little concrete ledge into deep shadow. At your feet, the dark waters lap quietly against the stones with a hollow, subterranean sound. Stone steps to the southeast lead back up to street level.

A small metal door, blotchy with rust, is set into the south bank of the river, underneath the bridge.

>e
You can return to the riverwalk by going up the stairs to the southeast, or you can go through the small, rusty door to the south.

>se
You can return to the riverwalk by going up the stairs to the southeast, or you can go through the small, rusty door to the south.

>u
Riverwalk
A low, irregular brick wall to the north divides this street from the steep, mud-slick banks of the sinuous Miskaton, while a rusty iron gate provides access to a precarious flight of stone steps leading down the bank to the water's edge. The street bends south here, turning into a misty avenue between the trees. The town square lies west, a vacant lot lies east.

>d
Under the Bridge
The ponderous stones of Whateley Bridge arch overhead, casting this little concrete ledge into deep shadow. At your feet, the dark waters lap quietly against the stones with a hollow, subterranean sound. Stone steps to the southeast lead back up to street level.

A small metal door, blotchy with rust, is set into the south bank of the river, underneath the bridge.

>x door
You see nothing special about the small metal door.

>x river
You can't see any such thing.

* * *

>s
The courthouse is closed for the day.

>scenes
Scene 'Entire Game' playing (for 4 mins now)
Scene 'Day 1' playing (for 4 mins now)
Scene 'Michael Reads' playing (for 4 mins now)
(Scene monitoring now switched on. Type "scenes off" to switch it off again.)

>s
You can't go that way.

>w
Dark Corner
The rooftops above you lean so close together as to nearly block out the sky altogether, making this a particularly dark and unpleasant section of the city. The street leads away to the east, and a shadowy driveway leads through a high brick wall to the south.

>s
Asylum Courtyard
The grim, white-washed edifice of Danvers Asylum bounds this tiny, shadowed courtyard to the south, its narrow, barred windows staring blankly down at you like ranks of shriveled, empty eye sockets. You can escape through a narrow gateway in the high, brick wall to the north.

>s
The asylum grounds are surrounded by a high brick wall, and the only way back to the outside world is to the north.

* * *

>s
The courthouse is closed for the day.

>sit on keyring
That's not something you can sit down on.

* * *

>se
You can't go that way.

* * *

>s
You can't go that way.

>e
Riverwalk
A low, irregular brick wall to the north divides this street from the steep, mud-slick banks of the sinuous Miskaton, while a rusty iron gate provides access to a precarious flight of stone steps leading down the bank to the water's edge. The street bends south here, turning into a misty avenue between the trees. The town square lies west, a vacant lot lies east.

* * *

>s
The street leads north and south from here, and another road splits off to the southwest.

>se
The street leads north and south from here, and another road splits off to the southwest.

* * *

>sw
Side Alley
This is a featureless blind alley, a dead end. Through the narrow and heavily shadowed opening to the northeast, you can see the square and the obelisk at its center.

>x obelisk
Although you're too far away to read the hieroglyphs on its sides, you have an otherwise excellent view of the obelisk from here.

>look at obelisk
Although you're too far away to read the hieroglyphs on its sides, you have an otherwise excellent view of the obelisk from here.

>ne
Town Square
A wide expanse of uneven pavestones lies open to the sky, bordered on all sides by the leaning, steep-roofed architecture that looms over everything in this city. The municipal courthouse stands at the south end of the square, next to the mouth of a dark, narrow alley to the southwest. Avenues to the west and east lead back into the cramped and ingrown streets, while to the north lies Whateley Bridge.

In the center of the square, rising from a circular lawn of unhealthy-looking grass and weeds, stands a strange, stone obelisk. It seems to be a monument of some sort, although you can see no plaque or marker anywhere near it.

>w
Dark Corner
The rooftops above you lean so close together as to nearly block out the sky altogether, making this a particularly dark and unpleasant section of the city. The street leads away to the east, and a shadowy driveway leads through a high brick wall to the south.

>w
The street leads east and south from here.

>s
Asylum Courtyard
The grim, white-washed edifice of Danvers Asylum bounds this tiny, shadowed courtyard to the south, its narrow, barred windows staring blankly down at you like ranks of shriveled, empty eye sockets. You can escape through a narrow gateway in the high, brick wall to the north.

* * *

>s
The asylum grounds are surrounded by a high brick wall, and the only way back to the outside world is to the north.

>s
The asylum grounds are surrounded by a high brick wall, and the only way back to the outside world is to the north.

* * *

>s
Whateley Bridge
A hoary monument of crumbling, moss-eaten flagstones, Whateley Bridge is possibly older than any other structure in the entire city. Ponderously it spans the dark, torpid waters of the Miskaton River, connecting the north and south halves of the city and occasionally raining bits of gravel and mortar from its underside into the water. It looks just wide enough for two cars to pass each other between the flanking stone parapets, but you wouldn't volunteer to try it.

>x parapets
The parapets are about waist high, made of crumbling stone.

>s
Town Square
A wide expanse of uneven pavestones lies open to the sky, bordered on all sides by the leaning, steep-roofed architecture that looms over everything in this city. The municipal courthouse stands at the south end of the square, next to the mouth of a dark, narrow alley to the southwest. Avenues to the west and east lead back into the cramped and ingrown streets, while to the north lies Whateley Bridge.

In the center of the square, rising from a circular lawn of unhealthy-looking grass and weeds, stands a strange, stone obelisk. It seems to be a monument of some sort, although you can see no plaque or marker anywhere near it.

>x lawn
You can't see any such thing.

>x courthouse
The courthouse is probably the largest building in the old city, although that isn't saying much. Built, like nearly every other structure here, with an eye toward steep roofs, leaning gables, and an overall air of looming decay, it casts its stern shadow across the square like an old Puritan magistrate passing judgment on some cowering sinner. Wide wooden steps lead up to its main entrance due south of here, while a narrow alley leads around the side of the building to the southwest.

>x bridge
Old Whateley Bridge spans the river to the north.

>n
Whateley Bridge
A hoary monument of crumbling, moss-eaten flagstones, Whateley Bridge is possibly older than any other structure in the entire city. Ponderously it spans the dark, torpid waters of the Miskaton River, connecting the north and south halves of the city and occasionally raining bits of gravel and mortar from its underside into the water. It looks just wide enough for two cars to pass each other between the flanking stone parapets, but you wouldn't volunteer to try it.

>x bridge
The parapets are about waist high, made of crumbling stone.

>s
Town Square
A wide expanse of uneven pavestones lies open to the sky, bordered on all sides by the leaning, steep-roofed architecture that looms over everything in this city. The municipal courthouse stands at the south end of the square, next to the mouth of a dark, narrow alley to the southwest. Avenues to the west and east lead back into the cramped and ingrown streets, while to the north lies Whateley Bridge.

In the center of the square, rising from a circular lawn of unhealthy-looking grass and weeds, stands a strange, stone obelisk. It seems to be a monument of some sort, although you can see no plaque or marker anywhere near it.

* * *

>w
Junction
To the north, a gap in the crowded press of gloomy buildings opens onto a country lane, heading out over a grassy heath. The main street continues to the east, while to the northwest, over the top of a steep rise, you can just make out the vaulted rooftops of the university.

>e
Narrow Street
As the lane winds along from east to west, it narrows until the steep, jagged rooftops on either side of the street practically touch each other. To the south, a side street leads across Whateley Bridge toward the center of town, and a twisting lane leads up a hill to the northwest. A short flight of steps to the north leads down to the local watering hole.

A wave of dizziness washes over you suddenly, making you light-headed. Your hand is swollen and throbbing a little, and your skin is flushed with an unpleasant, prickly heat. It occurs to you to wonder whether the spider that bit you might have been poisonous.

>showme player
There seems to be no such object anywhere in the model world.

>showme self
yourself - person
    clothes (worn)
    trenchcoat (worn)
    wedding ring (worn)
    keyring - open container
location: in Narrow Street
unlit, inedible, portable; transparent, male; singular-named, proper-named
description: "As good-looking as ever."
initial appearance: none
printing: "blank"
carrying capacity: 100
printed name: "yourself"
printed plural name: "people"
indefinite article: none
list grouping key: none
day: 1
spider: 0

* * *

>w
Junction
To the north, a gap in the crowded press of gloomy buildings opens onto a country lane, heading out over a grassy heath. The main street continues to the east, while to the northwest, over the top of a steep rise, you can just make out the vaulted rooftops of the university.

>n.
Mill Road
The road carries you across a desolate heath of gray, windswept grass. To the south, the black, jagged outline of Anchorhead's steep roofs and sharp, leaning gables cuts across the horizon. The road forks here to the west and east, heading across the railroad tracks in one direction, out toward the seashore in the other.

>w
As you cross the railroad tracks, the air becomes warmer, more dingy, and slightly more difficult to breathe.

Entrance to the Paper Mill
The road turns southwest here and runs squarely through the front entrance to the old paper mill. A gate of heavy iron bars blocks the only opening into this charred fortress, although an overgrown path leads around the wall to the south. To the north, a rutted lane threads its way past a row of dilapidated shacks.

You can see an iron gate here.

>sw
The road goes north and east from here. The mill gate lies southwest, and an overgrown trail leads south.

>x door
You can't see any such thing.

>x iron gate
The gate, a twenty-foot high barricade of narrowly spaced, thick, black, iron bars, is designed to roll horizontally, sealing off the entrance to the mill compound. It is currently shut and locked.  There are no guardhouses, no buzzers or intercoms, no apparent means of getting in or letting anyone inside know you want in; just this implacable gate in an unscalable wall.

>x gate
The gate, a twenty-foot high barricade of narrowly spaced, thick, black, iron bars, is designed to roll horizontally, sealing off the entrance to the mill compound. It is currently shut and locked.  There are no guardhouses, no buzzers or intercoms, no apparent means of getting in or letting anyone inside know you want in; just this implacable gate in an unscalable wall.

* * *

>e
Although these hallowed halls of learning probably hold a veritable trove of knowledge, you are no longer a student, and the only building you have any business in is the library.

>s
Although these hallowed halls of learning probably hold a veritable trove of knowledge, you are no longer a student, and the only building you have any business in is the library.

>se
Junction
To the north, a gap in the crowded press of gloomy buildings opens onto a country lane, heading out over a grassy heath. The main street continues to the east, while to the northwest, over the top of a steep rise, you can just make out the vaulted rooftops of the university.

>e
Narrow Street
As the lane winds along from east to west, it narrows until the steep, jagged rooftops on either side of the street practically touch each other. To the south, a side street leads across Whateley Bridge toward the center of town, and a twisting lane leads up a hill to the northwest. A short flight of steps to the north leads down to the local watering hole.

>e
Outside the Real Estate Office
A grim little cul-de-sac, tucked away in a corner of the claustrophobic tangle of narrow, twisting avenues that largely constitute the older portion of Anchorhead. Like most of the streets in this city, it is ancient, shadowy, and leads essentially nowhere. The lane ends here at the real estate agent's office, which lies to the east, and winds its way back toward the center of town to the west. A narrow, garbage-choked alley opens to the southeast.

>test window
(Testing.)

>[1] se

Alley
This narrow aperture between two buildings is nearly blocked with piles of rotting cardboard boxes and overstuffed garbage cans. Ugly, half-crumbling brick walls to either side totter oppressively over you. The alley ends here at a tall, wooden fence.

High up on the wall of the northern building there is a narrow, transom-style window. 

>[2] look through window
(the window)
The window is too high.

>[3] n
(first opening the window)
The window is too high.

>[4] move cans to window
Grunting and holding your breath, you manhandle one of the filthy cans under the window.

>[5] stand on cans
You clamber onto the wobbling garbage can, precariously balanced. You can just reach the lower edge of the window from here.

>[6] look through window
(the window)
Peering in through the foggy glass, you can see what looks like a file room.

>[7] n
(first getting off the cans)
(first opening the window)
The window is too high.

>[8] stand on cans
You clamber onto the wobbling garbage can, precariously balanced. You can just reach the lower edge of the window from here.

>[9] open window
(the window)
You open the window.

>[10] enter window
(the window)
(first getting off the cans)

File Room
Peering through the murk, you can make out the blocky outlines of filing cabinets lining the walls and a doorway to the west. A window high up on the south wall lets in a very faint illumination.

>cabinet
That's not a verb I recognise.

>test cabinet
(Testing.)

>[1] x cabinet
There must be hundreds of files here, too many to browse through. You'll have to look up something specific if you want to find anything.

>[2] consult cabinet about foo
You don't find anything filed under that foo.

>[3] consult cabinet about verlac
Strange; the file on the Verlac property has been cleaned out. Title, deed, all the papers, all of it gone. There is, however, a set of keys tucked down in the hanging folder. You quickly pocket them.

[Your score has just gone up by two points.]

>[4] g
You've already perused that file once.

You can hear a fly buzzing around, somewhere in this room.

>w
Office
Pallid gray light trickles in through the drawn blinds. The office is deserted, papers still scattered across the top of the desk. The front door lies west, and the file room lies east.

Sitting on the corner of the paper-strewn desk are a telephone and an answering machine.

Someone seems to have left a cup of coffee sitting out, half-finished and cold.

* * *

>unlock door
You unlock the office door.

>w
(first opening the office door)

Outside the Real Estate Office
A grim little cul-de-sac, tucked away in a corner of the claustrophobic tangle of narrow, twisting avenues that largely constitute the older portion of Anchorhead. Like most of the streets in this city, it is ancient, shadowy, and leads essentially nowhere. The lane ends here at the real estate agent's office, which lies to the east, and winds its way back toward the center of town to the west. A narrow, garbage-choked alley opens to the southeast.

The rain slackens off momentarily to a weak drizzle, then returns afresh in a brief, freezing downpour.

>w
Narrow Street
As the lane winds along from east to west, it narrows until the steep, jagged rooftops on either side of the street practically touch each other. To the south, a side street leads across Whateley Bridge toward the center of town, and a twisting lane leads up a hill to the northwest. A short flight of steps to the north leads down to the local watering hole.

The clouds overhead mutter restlessly to themselves.

>w
Junction
To the north, a gap in the crowded press of gloomy buildings opens onto a country lane, heading out over a grassy heath. The main street continues to the east, while to the northwest, over the top of a steep rise, you can just make out the vaulted rooftops of the university.

* * *

>w
Library
Shadows roost thickly in the vaulted ceiling, and small, green-shaded desk lamps cast pools of warm radiance here and there around the library's dim interior. You pause a moment to let the hushed peacefulness of this place soak in -- a welcome relief from the unsettling events of the day. An exit lies east, and a small alcove to the north houses the circulation counter.

Peering through the shadows, you spot your husband sitting at one of the reading desks, absorbed in some sort of weighty tome and clearly oblivious to the time.

>say hello to michael
Michael looks up, startled, then realizes it's you and smiles. "Hi, hon," he says, closing the book and stretching. Then he glances at his watch. "Good grief, what happened to the time? I'm so sorry -- I just lost track." He smiles sheepishly.

"Well?" he asks. "Did you get the keys?"

Michael turns to a new page in the book and begins reading intently.

>ask michael about verlac
Michael nods distractedly. He doesn't seem to be listening to you.

>show house key to michael
Michael is unimpressed.

>show cellar key to michael
Michael is unimpressed.

* * *

>w
Library
Shadows roost thickly in the vaulted ceiling, and small, green-shaded desk lamps cast pools of warm radiance here and there around the library's dim interior. You pause a moment to let the hushed peacefulness of this place soak in -- a welcome relief from the unsettling events of the day. An exit lies east, and a small alcove to the north houses the circulation counter.

Peering through the shadows, you spot your husband sitting at one of the reading desks, absorbed in some sort of weighty tome and clearly oblivious to the time.

>ask michael about verlac
Michael looks up, startled, then realizes it's you and smiles. "Hi, hon," he says, closing the book and stretching. Then he glances at his watch. "Good grief, what happened to the time? I'm so sorry -- I just lost track." He smiles sheepishly.

"Well?" he asks. "Did you get the keys?"

Michael turns to a new page in the book and begins reading intently.

>l
Library
Shadows roost thickly in the vaulted ceiling, and small, green-shaded desk lamps cast pools of warm radiance here and there around the library's dim interior. You pause a moment to let the hushed peacefulness of this place soak in -- a welcome relief from the unsettling events of the day. An exit lies east, and a small alcove to the north houses the circulation counter.

Peering through the shadows, you spot your husband sitting at one of the reading desks, absorbed in some sort of weighty tome and clearly oblivious to the time.

Michael turns to a new page in the book and begins reading intently.

>l
Library
Shadows roost thickly in the vaulted ceiling, and small, green-shaded desk lamps cast pools of warm radiance here and there around the library's dim interior. You pause a moment to let the hushed peacefulness of this place soak in -- a welcome relief from the unsettling events of the day. An exit lies east, and a small alcove to the north houses the circulation counter.

Peering through the shadows, you spot your husband sitting at one of the reading desks, absorbed in some sort of weighty tome and clearly oblivious to the time.

Michael turns to a new page in the book and begins reading intently.

* * *

>w
Library
Shadows roost thickly in the vaulted ceiling, and small, green-shaded desk lamps cast pools of warm radiance here and there around the library's dim interior. You pause a moment to let the hushed peacefulness of this place soak in -- a welcome relief from the unsettling events of the day. An exit lies east, and a small alcove to the north houses the circulation counter.

Peering through the shadows, you spot your husband sitting at one of the reading desks, absorbed in some sort of weighty tome and clearly oblivious to the time.

>l
Library
Shadows roost thickly in the vaulted ceiling, and small, green-shaded desk lamps cast pools of warm radiance here and there around the library's dim interior. You pause a moment to let the hushed peacefulness of this place soak in -- a welcome relief from the unsettling events of the day. An exit lies east, and a small alcove to the north houses the circulation counter.

Peering through the shadows, you spot your husband sitting at one of the reading desks, absorbed in some sort of weighty tome and clearly oblivious to the time.

>l
Library
Shadows roost thickly in the vaulted ceiling, and small, green-shaded desk lamps cast pools of warm radiance here and there around the library's dim interior. You pause a moment to let the hushed peacefulness of this place soak in -- a welcome relief from the unsettling events of the day. An exit lies east, and a small alcove to the north houses the circulation counter.

Peering through the shadows, you spot your husband sitting at one of the reading desks, absorbed in some sort of weighty tome and clearly oblivious to the time.

>e
University Court
Isolated and serene within its high, ivy-covered walls, Miskaton University represents this benighted town's single, if somewhat dubious, claim to cultural achievement. Founded some time in the early 1800s, the school's reputation and enrollment have diminished somewhat as Anchorhead drifts further and further into the abyss of provincial backwaterism. Still, it is generally recognized for its collection of folklore and esoteric mythology (one of the oldest and most extensive on the east coast). The Board of Deans was also kind enough to offer Michael a full professorship upon hearing of his recently discovered heritage and his plans to move into the estate. Ivory tower, perhaps, but at least they take care of their own.

There are numerous buildings surrounding this cobbled court, but the only one you are interested in is the library to the west, where Michael told you he'd be until he came back to the real estate agent's office to pick you up. Which, incidentally, he has not yet done.

>w
Library
Shadows roost thickly in the vaulted ceiling, and small, green-shaded desk lamps cast pools of warm radiance here and there around the library's dim interior. You pause a moment to let the hushed peacefulness of this place soak in -- a welcome relief from the unsettling events of the day. An exit lies east, and a small alcove to the north houses the circulation counter.

Peering through the shadows, you spot your husband sitting at one of the reading desks, absorbed in some sort of weighty tome and clearly oblivious to the time.

>restart
Are you sure you want to restart?

>yes
Informhead
An Interactive Fiction by Ed Peters
Release 1 / Serial number 230515 / Inform 7 v10.1.2 / D

Outside the Real Estate Office
A grim little cul-de-sac, tucked away in a corner of the claustrophobic tangle of narrow, twisting avenues that largely constitute the older portion of Anchorhead. Like most of the streets in this city, it is ancient, shadowy, and leads essentially nowhere. The lane ends here at the real estate agent's office, which lies to the east, and winds its way back toward the center of town to the west. A narrow, garbage-choked alley opens to the southeast.

* * *

>.l
That's not a verb I recognise.

>l
Library
Shadows roost thickly in the vaulted ceiling, and small, green-shaded desk lamps cast pools of warm radiance here and there around the library's dim interior. You pause a moment to let the hushed peacefulness of this place soak in -- a welcome relief from the unsettling events of the day. An exit lies east, and a small alcove to the north houses the circulation counter.

Michael is here.

>e
University Court
Isolated and serene within its high, ivy-covered walls, Miskaton University represents this benighted town's single, if somewhat dubious, claim to cultural achievement. Founded some time in the early 1800s, the school's reputation and enrollment have diminished somewhat as Anchorhead drifts further and further into the abyss of provincial backwaterism. Still, it is generally recognized for its collection of folklore and esoteric mythology (one of the oldest and most extensive on the east coast). The Board of Deans was also kind enough to offer Michael a full professorship upon hearing of his recently discovered heritage and his plans to move into the estate. Ivory tower, perhaps, but at least they take care of their own.

There are numerous buildings surrounding this cobbled court, but the only one you are interested in is the library to the west, where Michael told you he'd be until he came back to the real estate agent's office to pick you up. Which, incidentally, he has not yet done.

Michael follows you.

* * *

>w
Library
Shadows roost thickly in the vaulted ceiling, and small, green-shaded desk lamps cast pools of warm radiance here and there around the library's dim interior. You pause a moment to let the hushed peacefulness of this place soak in -- a welcome relief from the unsettling events of the day. An exit lies east, and a small alcove to the north houses the circulation counter.

Peering through the shadows, you spot your husband sitting at one of the reading desks, absorbed in some sort of weighty tome and clearly oblivious to the time.

>say hello to michael
Michael looks up, startled, then realizes it's you and smiles. "Hi, hon," he says, closing the book and stretching. Then he glances at his watch. "Good grief, what happened to the time? I'm so sorry -- I just lost track." He smiles sheepishly.

"Well?" he asks. "Did you get the keys?"

>e
University Court
Isolated and serene within its high, ivy-covered walls, Miskaton University represents this benighted town's single, if somewhat dubious, claim to cultural achievement. Founded some time in the early 1800s, the school's reputation and enrollment have diminished somewhat as Anchorhead drifts further and further into the abyss of provincial backwaterism. Still, it is generally recognized for its collection of folklore and esoteric mythology (one of the oldest and most extensive on the east coast). The Board of Deans was also kind enough to offer Michael a full professorship upon hearing of his recently discovered heritage and his plans to move into the estate. Ivory tower, perhaps, but at least they take care of their own.

There are numerous buildings surrounding this cobbled court, but the only one you are interested in is the library to the west, where Michael told you he'd be until he came back to the real estate agent's office to pick you up. Which, incidentally, he has not yet done.

* * *

>say hello to michael
Michael looks up, startled, then realizes it's you and smiles. "Hi, hon," he says, closing the book and stretching. Then he glances at his watch. "Good grief, what happened to the time? I'm so sorry -- I just lost track." He smiles sheepishly.

"Well?" he asks. "Did you get the keys?"

>l
Library
Shadows roost thickly in the vaulted ceiling, and small, green-shaded desk lamps cast pools of warm radiance here and there around the library's dim interior. You pause a moment to let the hushed peacefulness of this place soak in -- a welcome relief from the unsettling events of the day. An exit lies east, and a small alcove to the north houses the circulation counter.

Michael is here.

>x michael
Tall and a bit on the skinny side, in an endearingly awkward sort of way; a serious, thoughtful face topped with an unruly tangle of brown hair; deep brown eyes framed by wire-rimmed glasses -- yep, that's the man you married, all right.

>z
Time passes.

* * *

>w
Library
Shadows roost thickly in the vaulted ceiling, and small, green-shaded desk lamps cast pools of warm radiance here and there around the library's dim interior. You pause a moment to let the hushed peacefulness of this place soak in -- a welcome relief from the unsettling events of the day. An exit lies east, and a small alcove to the north houses the circulation counter.

Peering through the shadows, you spot your husband sitting at one of the reading desks, absorbed in some sort of weighty tome and clearly oblivious to the time.

>x michael
Tall and a bit on the skinny side, in an endearingly awkward sort of way; a serious, thoughtful face topped with an unruly tangle of brown hair; deep brown eyes framed by wire-rimmed glasses -- yep, that's the man you married, all right.

At the moment, Michael is largely absorbed in his reading, and is paying little attention to you.

>e
University Court
Isolated and serene within its high, ivy-covered walls, Miskaton University represents this benighted town's single, if somewhat dubious, claim to cultural achievement. Founded some time in the early 1800s, the school's reputation and enrollment have diminished somewhat as Anchorhead drifts further and further into the abyss of provincial backwaterism. Still, it is generally recognized for its collection of folklore and esoteric mythology (one of the oldest and most extensive on the east coast). The Board of Deans was also kind enough to offer Michael a full professorship upon hearing of his recently discovered heritage and his plans to move into the estate. Ivory tower, perhaps, but at least they take care of their own.

There are numerous buildings surrounding this cobbled court, but the only one you are interested in is the library to the west, where Michael told you he'd be until he came back to the real estate agent's office to pick you up. Which, incidentally, he has not yet done.

* * *

>l
University Court
Isolated and serene within its high, ivy-covered walls, Miskaton University represents this benighted town's single, if somewhat dubious, claim to cultural achievement. Founded some time in the early 1800s, the school's reputation and enrollment have diminished somewhat as Anchorhead drifts further and further into the abyss of provincial backwaterism. Still, it is generally recognized for its collection of folklore and esoteric mythology (one of the oldest and most extensive on the east coast). The Board of Deans was also kind enough to offer Michael a full professorship upon hearing of his recently discovered heritage and his plans to move into the estate. Ivory tower, perhaps, but at least they take care of their own.

There are numerous buildings surrounding this cobbled court, but the only one you are interested in is the library to the west, where Michael told you he'd be until he came back to the real estate agent's office to pick you up. Which, incidentally, he has not yet done.

Peering through the shadows, you spot your husband sitting at one of the reading desks, absorbed in some sort of weighty tome and clearly oblivious to the time.

* * *

>w
Library
Shadows roost thickly in the vaulted ceiling, and small, green-shaded desk lamps cast pools of warm radiance here and there around the library's dim interior. You pause a moment to let the hushed peacefulness of this place soak in -- a welcome relief from the unsettling events of the day. An exit lies east, and a small alcove to the north houses the circulation counter.

Peering through the shadows, you spot your husband sitting at one of the reading desks, absorbed in some sort of weighty tome and clearly oblivious to the time.

>x michael about verlac
I only understood you as far as wanting to examine Michael.

>x michael
Tall and a bit on the skinny side, in an endearingly awkward sort of way; a serious, thoughtful face topped with an unruly tangle of brown hair; deep brown eyes framed by wire-rimmed glasses -- yep, that's the man you married, all right.

At the moment, Michael is largely absorbed in his reading, and is paying little attention to you.

>ask michael about verlac
Michael looks up, startled, then realizes it's you and smiles. "Hi, hon," he says, closing the book and stretching. Then he glances at his watch. "Good grief, what happened to the time? I'm so sorry -- I just lost track." He smiles sheepishly.

"Well?" he asks. "Did you get the keys?"

Michael turns to a new page in the book and begins reading intently.

* * *

>l
Library
Shadows roost thickly in the vaulted ceiling, and small, green-shaded desk lamps cast pools of warm radiance here and there around the library's dim interior. You pause a moment to let the hushed peacefulness of this place soak in -- a welcome relief from the unsettling events of the day. An exit lies east, and a small alcove to the north houses the circulation counter.

Peering through the shadows, you spot your husband sitting at one of the reading desks, absorbed in some sort of weighty tome and clearly oblivious to the time.

>l
Library
Shadows roost thickly in the vaulted ceiling, and small, green-shaded desk lamps cast pools of warm radiance here and there around the library's dim interior. You pause a moment to let the hushed peacefulness of this place soak in -- a welcome relief from the unsettling events of the day. An exit lies east, and a small alcove to the north houses the circulation counter.

Peering through the shadows, you spot your husband sitting at one of the reading desks, absorbed in some sort of weighty tome and clearly oblivious to the time.

Michael turns to a new page in the book and begins reading intently.

* * *

>l
Library
Shadows roost thickly in the vaulted ceiling, and small, green-shaded desk lamps cast pools of warm radiance here and there around the library's dim interior. You pause a moment to let the hushed peacefulness of this place soak in -- a welcome relief from the unsettling events of the day. An exit lies east, and a small alcove to the north houses the circulation counter.

Peering through the shadows, you spot your husband sitting at one of the reading desks, absorbed in some sort of weighty tome and clearly oblivious to the time.

>x michael
Tall and a bit on the skinny side, in an endearingly awkward sort of way; a serious, thoughtful face topped with an unruly tangle of brown hair; deep brown eyes framed by wire-rimmed glasses -- yep, that's the man you married, all right.

At the moment, Michael is largely absorbed in his reading, and is paying little attention to you.

>say hello to michael
Michael nods distractedly. He doesn't seem to be listening to you.

>l
Library
Shadows roost thickly in the vaulted ceiling, and small, green-shaded desk lamps cast pools of warm radiance here and there around the library's dim interior. You pause a moment to let the hushed peacefulness of this place soak in -- a welcome relief from the unsettling events of the day. An exit lies east, and a small alcove to the north houses the circulation counter.

Peering through the shadows, you spot your husband sitting at one of the reading desks, absorbed in some sort of weighty tome and clearly oblivious to the time.

>x michael
Tall and a bit on the skinny side, in an endearingly awkward sort of way; a serious, thoughtful face topped with an unruly tangle of brown hair; deep brown eyes framed by wire-rimmed glasses -- yep, that's the man you married, all right.

At the moment, Michael is largely absorbed in his reading, and is paying little attention to you.

Michael turns to a new page in the book and begins reading intently.

>ask michael about verlac
Michael nods distractedly. He doesn't seem to be listening to you.

>show keys to michael
You can't see any such thing.

>e
University Court
Isolated and serene within its high, ivy-covered walls, Miskaton University represents this benighted town's single, if somewhat dubious, claim to cultural achievement. Founded some time in the early 1800s, the school's reputation and enrollment have diminished somewhat as Anchorhead drifts further and further into the abyss of provincial backwaterism. Still, it is generally recognized for its collection of folklore and esoteric mythology (one of the oldest and most extensive on the east coast). The Board of Deans was also kind enough to offer Michael a full professorship upon hearing of his recently discovered heritage and his plans to move into the estate. Ivory tower, perhaps, but at least they take care of their own.

There are numerous buildings surrounding this cobbled court, but the only one you are interested in is the library to the west, where Michael told you he'd be until he came back to the real estate agent's office to pick you up. Which, incidentally, he has not yet done.

>s
Although these hallowed halls of learning probably hold a veritable trove of knowledge, you are no longer a student, and the only building you have any business in is the library.

>e
Although these hallowed halls of learning probably hold a veritable trove of knowledge, you are no longer a student, and the only building you have any business in is the library.

>e
Although these hallowed halls of learning probably hold a veritable trove of knowledge, you are no longer a student, and the only building you have any business in is the library.

>se
Junction
To the north, a gap in the crowded press of gloomy buildings opens onto a country lane, heading out over a grassy heath. The main street continues to the east, while to the northwest, over the top of a steep rise, you can just make out the vaulted rooftops of the university.

>e
Narrow Street
As the lane winds along from east to west, it narrows until the steep, jagged rooftops on either side of the street practically touch each other. To the south, a side street leads across Whateley Bridge toward the center of town, and a twisting lane leads up a hill to the northwest. A short flight of steps to the north leads down to the local watering hole.

The clouds overhead mutter restlessly to themselves.

>e
Outside the Real Estate Office
A grim little cul-de-sac, tucked away in a corner of the claustrophobic tangle of narrow, twisting avenues that largely constitute the older portion of Anchorhead. Like most of the streets in this city, it is ancient, shadowy, and leads essentially nowhere. The lane ends here at the real estate agent's office, which lies to the east, and winds its way back toward the center of town to the west. A narrow, garbage-choked alley opens to the southeast.

>test window
(Testing.)

>[1] se

Alley
This narrow aperture between two buildings is nearly blocked with piles of rotting cardboard boxes and overstuffed garbage cans. Ugly, half-crumbling brick walls to either side totter oppressively over you. The alley ends here at a tall, wooden fence.

High up on the wall of the northern building there is a narrow, transom-style window. 

>[2] look through window
(the window)
The window is too high.

>[3] n
(first opening the window)
The window is too high.

>[4] move cans to window
Grunting and holding your breath, you manhandle one of the filthy cans under the window.

>[5] stand on cans
You clamber onto the wobbling garbage can, precariously balanced. You can just reach the lower edge of the window from here.

>[6] look through window
(the window)
Peering in through the foggy glass, you can see what looks like a file room.

Overhead, the swollen clouds flicker ominously with a greenish haze of sheet lightning.

>[7] n
(first getting off the cans)
(first opening the window)
The window is too high.

>[8] stand on cans
You clamber onto the wobbling garbage can, precariously balanced. You can just reach the lower edge of the window from here.

>[9] open window
(the window)
You open the window.

>[10] enter window
(the window)
(first getting off the cans)

File Room
Peering through the murk, you can make out the blocky outlines of filing cabinets lining the walls and a doorway to the west. A window high up on the south wall lets in a very faint illumination.

>consult cabinet about verlac
Strange; the file on the Verlac property has been cleaned out. Title, deed, all the papers, all of it gone. There is, however, a set of keys tucked down in the hanging folder. You quickly pocket them.

You can hear a fly buzzing around, somewhere in this room.

[Your score has just gone up by two points.]

>consult cabinet about verlac
Strange; the file on the Verlac property has been cleaned out. Title, deed, all the papers, all of it gone. There is, however, a set of keys tucked down in the hanging folder. You quickly pocket them.

You can hear a fly buzzing around, somewhere in the next room.

[Your score has just gone up by two points.]

>consult cabinet about verlac
Strange; the file on the Verlac property has been cleaned out. Title, deed, all the papers, all of it gone. There is, however, a set of keys tucked down in the hanging folder. You quickly pocket them.

You can hear a fly buzzing around, somewhere in the next room.

[Your score has just gone up by two points.]

* * *

>w
Junction
To the north, a gap in the crowded press of gloomy buildings opens onto a country lane, heading out over a grassy heath. The main street continues to the east, while to the northwest, over the top of a steep rise, you can just make out the vaulted rooftops of the university.

>w
The street goes east and northwest, or you can take the road out of town to the north.

>e
Narrow Street
As the lane winds along from east to west, it narrows until the steep, jagged rooftops on either side of the street practically touch each other. To the south, a side street leads across Whateley Bridge toward the center of town, and a twisting lane leads up a hill to the northwest. A short flight of steps to the north leads down to the local watering hole.

* * *

>e
University Court
Isolated and serene within its high, ivy-covered walls, Miskaton University represents this benighted town's single, if somewhat dubious, claim to cultural achievement. Founded some time in the early 1800s, the school's reputation and enrollment have diminished somewhat as Anchorhead drifts further and further into the abyss of provincial backwaterism. Still, it is generally recognized for its collection of folklore and esoteric mythology (one of the oldest and most extensive on the east coast). The Board of Deans was also kind enough to offer Michael a full professorship upon hearing of his recently discovered heritage and his plans to move into the estate. Ivory tower, perhaps, but at least they take care of their own.

There are numerous buildings surrounding this cobbled court, but the only one you are interested in is the library to the west, where Michael told you he'd be until he came back to the real estate agent's office to pick you up. Which, incidentally, he has not yet done.

>w
Library
Shadows roost thickly in the vaulted ceiling, and small, green-shaded desk lamps cast pools of warm radiance here and there around the library's dim interior. You pause a moment to let the hushed peacefulness of this place soak in -- a welcome relief from the unsettling events of the day. An exit lies east, and a small alcove to the north houses the circulation counter.

Michael is here.

>scene
That's not a verb I recognise.

>scenes
Scene 'Entire Game' playing (for 22 mins now)
Scene 'Day 1' playing (for 22 mins now)
Scene 'Michael Reads' playing (for 22 mins now)
(Scene monitoring now switched on. Type "scenes off" to switch it off again.)

>showme michael
Michael - man
location: in the Library
unlit, inedible, portable; transparent, male; singular-named, proper-named; greeted
description: "Tall and a bit on the skinny side, in an endearingly awkward sort of way; a serious, thoughtful face topped with an unruly tangle of brown hair; deep brown eyes framed by wire-rimmed glasses -- yep, that's the man you married, all right.

Michael looks at you expectantly, waiting for you to lead the way."
initial appearance: "Michael is here."
carrying capacity: 100
printed name: "Michael"
printed plural name: "men"
indefinite article: none
list grouping key: none
goal: follow

* * *

>w
The street goes east and northwest, or you can take the road out of town to the north.

>nw
University Court
Isolated and serene within its high, ivy-covered walls, Miskaton University represents this benighted town's single, if somewhat dubious, claim to cultural achievement. Founded some time in the early 1800s, the school's reputation and enrollment have diminished somewhat as Anchorhead drifts further and further into the abyss of provincial backwaterism. Still, it is generally recognized for its collection of folklore and esoteric mythology (one of the oldest and most extensive on the east coast). The Board of Deans was also kind enough to offer Michael a full professorship upon hearing of his recently discovered heritage and his plans to move into the estate. Ivory tower, perhaps, but at least they take care of their own.

There are numerous buildings surrounding this cobbled court, but the only one you are interested in is the library to the west, where Michael told you he'd be until he came back to the real estate agent's office to pick you up. Which, incidentally, he has not yet done.

* * *

>scenes
Scene 'Entire Game' playing (for 15 mins now)
Scene 'Day 1' playing (for 15 mins now)
Scene 'Michael Reads' ended
Scene 'Michael Follows' playing (for 1 mins now)
(Scene monitoring now switched on. Type "scenes off" to switch it off again.)

>show michael
What do you want to show Michael?

>showme michael
Michael - man
location: in the Library
unlit, inedible, portable; transparent, male; singular-named, proper-named; greeted
description: "Tall and a bit on the skinny side, in an endearingly awkward sort of way; a serious, thoughtful face topped with an unruly tangle of brown hair; deep brown eyes framed by wire-rimmed glasses -- yep, that's the man you married, all right.

Michael looks at you expectantly, waiting for you to lead the way."
initial appearance: "Michael is here."
carrying capacity: 100
printed name: "Michael"
printed plural name: "men"
indefinite article: none
list grouping key: none
goal: follow

>e
University Court
Isolated and serene within its high, ivy-covered walls, Miskaton University represents this benighted town's single, if somewhat dubious, claim to cultural achievement. Founded some time in the early 1800s, the school's reputation and enrollment have diminished somewhat as Anchorhead drifts further and further into the abyss of provincial backwaterism. Still, it is generally recognized for its collection of folklore and esoteric mythology (one of the oldest and most extensive on the east coast). The Board of Deans was also kind enough to offer Michael a full professorship upon hearing of his recently discovered heritage and his plans to move into the estate. Ivory tower, perhaps, but at least they take care of their own.

There are numerous buildings surrounding this cobbled court, but the only one you are interested in is the library to the west, where Michael told you he'd be until he came back to the real estate agent's office to pick you up. Which, incidentally, he has not yet done.

Michael follows you.

>se
Junction
To the north, a gap in the crowded press of gloomy buildings opens onto a country lane, heading out over a grassy heath. The main street continues to the east, while to the northwest, over the top of a steep rise, you can just make out the vaulted rooftops of the university.

Michael follows you.

>e
Narrow Street
As the lane winds along from east to west, it narrows until the steep, jagged rooftops on either side of the street practically touch each other. To the south, a side street leads across Whateley Bridge toward the center of town, and a twisting lane leads up a hill to the northwest. A short flight of steps to the north leads down to the local watering hole.

Michael follows you.

>s
Whateley Bridge
A hoary monument of crumbling, moss-eaten flagstones, Whateley Bridge is possibly older than any other structure in the entire city. Ponderously it spans the dark, torpid waters of the Miskaton River, connecting the north and south halves of the city and occasionally raining bits of gravel and mortar from its underside into the water. It looks just wide enough for two cars to pass each other between the flanking stone parapets, but you wouldn't volunteer to try it.

Michael follows you.

>restart
Are you sure you want to restart?

* * *

>s
Outside the House
The lane runs up from the southeast and ends at a wide clearing surrounded by gnarled and ancient trees. A wide, curving driveway runs up to the front door of your house, which lies north.

The Verlac mansion looms before you, casting an air of menace ove the clearing.

A typewritten notice has been attached to the front door.

* * *

The oldest and strongest emotion of mankind
is fear, and the oldest and strongest kind of
fear is fear of the unknown.

-- H.P. Lovecraft
                                                                                                                                                                                                                                                  I N F O R M H E A D

Please press SPACE to continue.

>w . w. n .
Narrow Street
As the lane winds along from east to west, it narrows until the steep, jagged rooftops on either side of the street practically touch each other. To the south, a side street leads across Whateley Bridge toward the center of town, and a twisting lane leads up a hill to the northwest. A short flight of steps to the north leads down to the local watering hole.

Junction
To the north, a gap in the crowded press of gloomy buildings opens onto a country lane, heading out over a grassy heath. The main street continues to the east, while to the northwest, over the top of a steep rise, you can just make out the vaulted rooftops of the university.

Mill Road
The road carries you across a desolate heath of gray, windswept grass. To the south, the black, jagged outline of Anchorhead's steep roofs and sharp, leaning gables cuts across the horizon. The road forks here to the west and east, heading across the railroad tracks in one direction, out toward the seashore in the other.

>test spur
(Testing.)

>[1] e

Breakwater
You are picking your way across the breakwater's bare, rocky spine, where the road has diminished to little more than a pair of dusty ruts. A hundred yards to the northeast, at the breakwater's far end, the lonely stone tower of Anchorhead's lighthouse stands vigil against the ocean.

>[2] ne

At the Foot of the Lighthouse
You stand in a circular clearing among the stones, surrounded on nearly every side by the sea. Before you looms the ancient, massive lighthouse, a vertiginous pillar of pale brick jabbing defiantly up at the sky. The road from the southwest ends here, although it looks as though you could pick your way down the rocks to the southeast, around the structure's base.

You can see a bronze door here.

>[3] se
Carefully, you climb down the rocks. The path bends northeast, following the curve of the lighthouse wall.

Rocky Spur
A small outcropping of stone, just large enough for you to stand on, sticks out from the end of the breakwater. The hungry sea laps at your feet, surging over the rocks and then trickling down into crevices. To the southwest, an uneven trail leads back up the rocks, around the side of the lighthouse.

>[4] nw
You can't go that way.

>[5] u
You can't go that way.

>[6] d
You can't go that way.

* * *

The oldest and strongest emotion of mankind
is fear, and the oldest and strongest kind of
fear is fear of the unknown.

-- H.P. Lovecraft
                                                                                                                                                                                                                                                  I N F O R M H E A D

Please press SPACE to continue.

>w.
Narrow Street
As the lane winds along from east to west, it narrows until the steep, jagged rooftops on either side of the street practically touch each other. To the south, a side street leads across Whateley Bridge toward the center of town, and a twisting lane leads up a hill to the northwest. A short flight of steps to the north leads down to the local watering hole.

>nw
Twisting Lane
The lane narrows here to little more than a badly cobbled sidewalk as it wends its way up through a series of tortuous bends and switchbacks. In some places, the street is so steep that steps have been cut into it, worn down over the years and slick with moss. Your progress is blocked at the top of the street by a blank brick wall.

>sw
Narrow Street
As the lane winds along from east to west, it narrows until the steep, jagged rooftops on either side of the street practically touch each other. To the south, a side street leads across Whateley Bridge toward the center of town, and a twisting lane leads up a hill to the northwest. A short flight of steps to the north leads down to the local watering hole.

>u
Twisting Lane
The lane narrows here to little more than a badly cobbled sidewalk as it wends its way up through a series of tortuous bends and switchbacks. In some places, the street is so steep that steps have been cut into it, worn down over the years and slick with moss. Your progress is blocked at the top of the street by a blank brick wall.

>d
You take a few tentative steps back down the lane, but it seems to lead only to a short switchback, bringing you right back to the brick wall. You're not entirely sure now, which direction leads back to the narrow street.

>sw
Narrow Street
As the lane winds along from east to west, it narrows until the steep, jagged rooftops on either side of the street practically touch each other. To the south, a side street leads across Whateley Bridge toward the center of town, and a twisting lane leads up a hill to the northwest. A short flight of steps to the north leads down to the local watering hole.

* * *

>u
Twisting Lane
The lane narrows here to little more than a badly cobbled sidewalk as it wends its way up through a series of tortuous bends and switchbacks. In some places, the street is so steep that steps have been cut into it, worn down over the years and slick with moss. Your progress is blocked at the top of the street by a blank brick wall.

>x wall
You see nothing special about the brick wall.

>n
You take a few tentative steps back down the lane, but it seems to lead only to a short switchback, bringing you right back to the brick wall. You're not entirely sure now, which direction leads back to the narrow street.

>w
You take a few tentative steps back down the lane, but it seems to lead only to a short switchback, bringing you right back to the brick wall. You're not entirely sure now, which direction leads back to the narrow street.

Hidden Court
You had no idea this little courtyard even existed, cleverly tucked away amidst the confusing tangle of darker avenues. Although surrounded on all sides by steep rooftops and overshadowed by the ever- ominous clouds, this secluded circle somehow manages to convey a sense of peace and brightness, a safe harbor from the oppressive gloom pervading the rest of the town. To the south, a hanging sign marks a humble shop, while a sidestreet to the east leads back into the labyrinth.

>showme graffiti
graffiti - thing
location: out of play
unlit, inedible, fixed in place; singular-named, improper-named
description: "It's a strange design done in black spraypaint; an upturned hand with an irregular triangle inscribed in the palm. Beneath it is drawn an arrow pointing roughly west, and following it with your gaze, you realize that it points directly at the narrow aperture of a sidestreet you'd never noticed before."
initial appearance: "Someone has sprayed graffiti across the wall in black spray paint."
last turn examined: -2
printing: "blank"
printed name: "graffiti"
printed plural name: none
indefinite article: none
list grouping key: none

* * *

>w.
Narrow Street
As the lane winds along from east to west, it narrows until the steep, jagged rooftops on either side of the street practically touch each other. To the south, a side street leads across Whateley Bridge toward the center of town, and a twisting lane leads up a hill to the northwest. A short flight of steps to the north leads down to the local watering hole.

>nw.
The street goes east and west; you can also take a side street to the south, or go up a narrow, twisting lane to the northwest. The pub is down a short flight of steps to the north.

>nw
The street goes east and west; you can also take a side street to the south, or go up a narrow, twisting lane to the northwest. The pub is down a short flight of steps to the north.

* * *

The oldest and strongest emotion of mankind
is fear, and the oldest and strongest kind of
fear is fear of the unknown.

-- H.P. Lovecraft
                                                                                                                                                                                                                                                  I N F O R M H E A D

Please press SPACE to continue.

>w. nw. w. s.
Narrow Street
As the lane winds along from east to west, it narrows until the steep, jagged rooftops on either side of the street practically touch each other. To the south, a side street leads across Whateley Bridge toward the center of town, and a twisting lane leads up a hill to the northwest. A short flight of steps to the north leads down to the local watering hole.

Twisting Lane
The lane narrows here to little more than a badly cobbled sidewalk as it wends its way up through a series of tortuous bends and switchbacks. In some places, the street is so steep that steps have been cut into it, worn down over the years and slick with moss. Your progress is blocked at the top of the street by a brick wall.

Someone has sprayed graffiti across the wall in black spray paint.

Hidden Court
You had no idea this little courtyard even existed, cleverly tucked away amidst the confusing tangle of darker avenues. Although surrounded on all sides by steep rooftops and overshadowed by the ever- ominous clouds, this secluded circle somehow manages to convey a sense of peace and brightness, a safe harbor from the oppressive gloom pervading the rest of the town. To the south, a hanging sign marks a humble shop, while a sidestreet to the east leads back into the labyrinth.

A silvery bell jingles as you open the door.

Cauldron
A warm and pleasantly dim light surrounds you and suffuses this cozy little shop. The shelves are crammed with every conceivable variety of new age curiosity: books, crystals, pendants, charms, herbs, potions, incense, candles and -- sure enough, on a display stand right near the door -- decorative cast-iron cauldron-shaped paperweights. How cute. In the rear of the store, a lit display case contains several items of interest. The courtyard lies outside, to the north.

On the display case is a violin.

You can also see a proprietor here.

>ask proprietor about amulet
The proprietor reaches in through the back of the case and takes out the amulet. It spins slowly as he holds it up to the light.

"I think, perhaps, that he eventually found different. And I think, perhaps, that you will, too." He leans forward and, before you can react, slips the leather thong around your neck. "But you won't make the same mistake, will you, Miss? No. You go on and keep that, now. My treat. You may find it useful soon."

(first taking the amulet)
You put on the amulet.

[Your score has just gone up by five points.]

>i
You are carrying:
  an amulet (being worn)
  A Historical Overview of Superstitions by J. Arnsworth Frazer
  your clothes (being worn)
  your trenchcoat (being worn)
  your wedding ring (being worn)
  your umbrella
  your keyring

>l
Cauldron
A warm and pleasantly dim light surrounds you and suffuses this cozy little shop. The shelves are crammed with every conceivable variety of new age curiosity: books, crystals, pendants, charms, herbs, potions, incense, candles and -- sure enough, on a display stand right near the door -- decorative cast-iron cauldron-shaped paperweights. How cute. In the rear of the store, a lit display case contains several items of interest. The courtyard lies outside, to the north.

On the display case is a violin.

You can also see a proprietor here.

* * *

>x tarot
A beautiful set of cards in a velvet-lined box. The top card, "The Tower", has been turned up, allowing you to see the exquisitely detailed artwork. In this representation, the tower has been painted to resemble a lighthouse, broken by a bolt of lightning emanating from a great, red-rimmed eye. Two figures, a man and a woman, tumble from the tower's summit, cast lifelessly into the sea.

>ask proprietor about tarot
"Mmm, yes, a rare piece of work. The cards are actually very delicate, thinly sliced ivory. Almost transparent. The box is walnut." He leans toward you, offering you a salesman's conspiratorial wink. "They say," he whispers, "that this very deck was used and endorsed by the infamous medium -- " he frowns. "Not Blavatski; the other one. What was her name? Anyway, it is said that by shining a light through the cards and projecting the image onto a wall, you may open gateways to other worlds. Frankly, I don't buy it."

>ask proprietor about geode
"Nice, isn't it?" beams the proprietor. "I chanced upon it while rock-hunting in the Cascades last summer."

>ask proprietor about amulet
The proprietor reaches in through the back of the case and takes out the amulet. It spins slowly as he holds it up to the light.

"I think, perhaps, that he eventually found different. And I think, perhaps, that you will, too." He leans forward and, before you can react, slips the leather thong around your neck. "But you won't make the same mistake, will you, Miss? No. You go on and keep that, now. My treat. You may find it useful soon."

(first taking the amulet)
You can't wear that!

[Your score has just gone up by five points.]

* * *

>x violin
It's a gorgeous instrument -- the wood is a rich, polished mahogany, the scroll and fingerboard gleaming ebony. The strings almost seem to vibrate of their own accord, as if aching to be played.

>x case
The display case has a glass front and sliding doors in back that allow the proprietor to reach inside. Lined up inside the case are set of tarot cards, geode and amulet. Resting on top of the case is a violin.

>c cards
That's not a verb I recognise.

>x cards
You see nothing special about the set of tarot cards.

* * *

The oldest and strongest emotion of mankind
is fear, and the oldest and strongest kind of
fear is fear of the unknown.

-- H.P. Lovecraft
                                                                                                                                                                                                                                                  I N F O R M H E A D

Please press SPACE to continue.

>w. nw. w. s. give puzzle box to proprietor.
Narrow Street
As the lane winds along from east to west, it narrows until the steep, jagged rooftops on either side of the street practically touch each other. To the south, a side street leads across Whateley Bridge toward the center of town, and a twisting lane leads up a hill to the northwest. A short flight of steps to the north leads down to the local watering hole.

Twisting Lane
The lane narrows here to little more than a badly cobbled sidewalk as it wends its way up through a series of tortuous bends and switchbacks. In some places, the street is so steep that steps have been cut into it, worn down over the years and slick with moss. Your progress is blocked at the top of the street by a brick wall.

Someone has sprayed graffiti across the wall in black spray paint.

Hidden Court
You had no idea this little courtyard even existed, cleverly tucked away amidst the confusing tangle of darker avenues. Although surrounded on all sides by steep rooftops and overshadowed by the ever- ominous clouds, this secluded circle somehow manages to convey a sense of peace and brightness, a safe harbor from the oppressive gloom pervading the rest of the town. To the south, a hanging sign marks a humble shop, while a sidestreet to the east leads back into the labyrinth.

A silvery bell jingles as you open the door.

Cauldron
A warm and pleasantly dim light surrounds you and suffuses this cozy little shop. The shelves are crammed with every conceivable variety of new age curiosity: books, crystals, pendants, charms, herbs, potions, incense, candles and -- sure enough, on a display stand right near the door -- decorative cast-iron cauldron-shaped paperweights. How cute. In the rear of the store, a lit display case contains several items of interest. The courtyard lies outside, to the north.

On the display case is a violin.

The proprietor watches you quietly from behind the display case.

The proprietor takes the puzzle box and turns it over in his hands carefully. "Now, this is a tricky one," he says. "They don't make them like this anymore. Frightfully difficult, unless you know the catch of course." His fingers flicker dexterously over the box, sliding a panel here, pressing a corner in there. Suddenly the lid pops open with a faint snick.

"And there you have it," he says. "A present for you." He hands it back to you.

[Your score has just gone up by two points.]

>x box
It's roughly the size and shape of a cigar box, carved from some dark and oddly streaked wood that you can't identify. All six surfaces are decorated in a complex arrangement of grooves and panels, most of which are illustrated with leering, demonic faces and obscene designs.

In the puzzle box is a strange black disk.

* * *

>x disk
It's a dark, glassy circle, about the width of your hand in diameter and half an inch thick in the middle, tapering off to thinness toward the edge like a convex lens. Its color is the deep, oily black of obsidian, though you fancy you can see faint swirls of color inside it like the rainbow sheen of oil on water. Its curved surface is cool and perfectly smooth. Although incredibly hard, the material does not feel like stone; there is an odd, yielding quality to it, almost like something organic... almost, you realize with disquiet, like skin.

>look through it
Putting it to your eye, you see faint streaks of color. They swirl and dissolve within the strange lens like oil on the surface of water. Gradually it becomes slightly transparent, but the objects seen through it are grotesquely distorted and dark, as though seen in photographic negative.

* * *

The oldest and strongest emotion of mankind
is fear, and the oldest and strongest kind of
fear is fear of the unknown.

-- H.P. Lovecraft
                                                                                                                                                                                                                                                  I N F O R M H E A D

Please press SPACE to continue.

>w. s. s.
Narrow Street
As the lane winds along from east to west, it narrows until the steep, jagged rooftops on either side of the street practically touch each other. To the south, a side street leads across Whateley Bridge toward the center of town, and a twisting lane leads up a hill to the northwest. A short flight of steps to the north leads down to the local watering hole.

Whateley Bridge
A hoary monument of crumbling, moss-eaten flagstones, Whateley Bridge is possibly older than any other structure in the entire city. Ponderously it spans the dark, torpid waters of the Miskaton River, connecting the north and south halves of the city and occasionally raining bits of gravel and mortar from its underside into the water. It looks just wide enough for two cars to pass each other between the flanking stone parapets, but you wouldn't volunteer to try it.

Town Square
A wide expanse of uneven pavestones lies open to the sky, bordered on all sides by the leaning, steep-roofed architecture that looms over everything in this city. The municipal courthouse stands at the south end of the square, next to the mouth of a dark, narrow alley to the southwest. Avenues to the west and east lead back into the cramped and ingrown streets, while to the north lies Whateley Bridge.

In the center of the square, rising from a circular lawn of unhealthy-looking grass and weeds, stands a strange, stone obelisk. It seems to be a monument of some sort, although you can see no plaque or marker anywhere near it.

>s
The courthouse is closed for the day.

>sw
Side Alley
This is a featureless blind alley, a dead end. Through the narrow and heavily shadowed opening to the northeast, you can see the square and the obelisk at its center.

>s
The only exit is to the northeast.

>ne
Town Square
A wide expanse of uneven pavestones lies open to the sky, bordered on all sides by the leaning, steep-roofed architecture that looms over everything in this city. The municipal courthouse stands at the south end of the square, next to the mouth of a dark, narrow alley to the southwest. Avenues to the west and east lead back into the cramped and ingrown streets, while to the north lies Whateley Bridge.

In the center of the square, rising from a circular lawn of unhealthy-looking grass and weeds, stands a strange, stone obelisk. It seems to be a monument of some sort, although you can see no plaque or marker anywhere near it.

* * *

>s
Asylum Courtyard
The grim, white-washed edifice of Danvers Asylum bounds this tiny, shadowed courtyard to the south, its narrow, barred windows staring blankly down at you like ranks of shriveled, empty eye sockets. You can escape through a narrow gateway in the high, brick wall to the north.

>s
The asylum is closed for the day.

* * *

The oldest and strongest emotion of mankind
is fear, and the oldest and strongest kind of
fear is fear of the unknown.

-- H.P. Lovecraft
                                                                                                                                                                                                                                                  I N F O R M H E A D

Please press SPACE to continue.

>w. s. s. s.
Narrow Street
As the lane winds along from east to west, it narrows until the steep, jagged rooftops on either side of the street practically touch each other. To the south, a side street leads across Whateley Bridge toward the center of town, and a twisting lane leads up a hill to the northwest. A short flight of steps to the north leads down to the local watering hole.

Whateley Bridge
A hoary monument of crumbling, moss-eaten flagstones, Whateley Bridge is possibly older than any other structure in the entire city. Ponderously it spans the dark, torpid waters of the Miskaton River, connecting the north and south halves of the city and occasionally raining bits of gravel and mortar from its underside into the water. It looks just wide enough for two cars to pass each other between the flanking stone parapets, but you wouldn't volunteer to try it.

Town Square
A wide expanse of uneven pavestones lies open to the sky, bordered on all sides by the leaning, steep-roofed architecture that looms over everything in this city. The municipal courthouse stands at the south end of the square, next to the mouth of a dark, narrow alley to the southwest. Avenues to the west and east lead back into the cramped and ingrown streets, while to the north lies Whateley Bridge.

In the center of the square, rising from a circular lawn of unhealthy-looking grass and weeds, stands a strange, stone obelisk. It seems to be a monument of some sort, although you can see no plaque or marker anywhere near it.

Courthouse
A long, dimly lit, north-south corridor stretches away from the courthouse entrance. Closed, unmarked doors line either side of the hall, their pebbled glass windows lit from within by a murky, yellow-orange light. Silence reigns here; your footsteps echo eerily on the tiled floor, and occasionally you can hear muted conversation behind one of the doors -- you can't tell which. At the hall's southern end, a staircase leads down into the basement; a sign hanging above it reads "RECORDS". You can return to Town Square to the north.

>d.
Courthouse Basement
A single bulb dangling from the ceiling casts a watery, yellow light against the brick walls. A rickety staircase to the north leads back up to the ground floor, and two narrow doorways lead into the record archives. Over the southeast door hangs a sign that reads "BIRTH RECORDS", while the southwest door bears the sign "DEATH RECORDS".

>se.
Birth Records
A bare room with cinderblock walls. Thousands of records and documents, most yellow and brittle with age, are stacked everywhere in towering piles. The exit lies northwest.

>consult records about wilhelm
wilhelmwilhelmheinrichelijahmordecaiedwardYou can't find that name anywhere in the records.

* * *

>s
All of the doors are locked.

>d
Courthouse Basement
A single bulb dangling from the ceiling casts a watery, yellow light against the brick walls. A rickety staircase to the north leads back up to the ground floor, and two narrow doorways lead into the record archives. Over the southeast door hangs a sign that reads "BIRTH RECORDS", while the southwest door bears the sign "DEATH RECORDS".

>se
Birth Records
A bare room with cinderblock walls. Thousands of records and documents, most yellow and brittle with age, are stacked everywhere in towering piles. The exit lies northwest.

>consult records about wilhelm
You can't find that name anywhere in the records.

* * *

The oldest and strongest emotion of mankind
is fear, and the oldest and strongest kind of
fear is fear of the unknown.

-- H.P. Lovecraft
                                                                                                                                                                                                                                                  I N F O R M H E A D

Please press SPACE to continue.

>w. s. s. s. d. se.
Narrow Street
As the lane winds along from east to west, it narrows until the steep, jagged rooftops on either side of the street practically touch each other. To the south, a side street leads across Whateley Bridge toward the center of town, and a twisting lane leads up a hill to the northwest. A short flight of steps to the north leads down to the local watering hole.

Whateley Bridge
A hoary monument of crumbling, moss-eaten flagstones, Whateley Bridge is possibly older than any other structure in the entire city. Ponderously it spans the dark, torpid waters of the Miskaton River, connecting the north and south halves of the city and occasionally raining bits of gravel and mortar from its underside into the water. It looks just wide enough for two cars to pass each other between the flanking stone parapets, but you wouldn't volunteer to try it.

Town Square
A wide expanse of uneven pavestones lies open to the sky, bordered on all sides by the leaning, steep-roofed architecture that looms over everything in this city. The municipal courthouse stands at the south end of the square, next to the mouth of a dark, narrow alley to the southwest. Avenues to the west and east lead back into the cramped and ingrown streets, while to the north lies Whateley Bridge.

In the center of the square, rising from a circular lawn of unhealthy-looking grass and weeds, stands a strange, stone obelisk. It seems to be a monument of some sort, although you can see no plaque or marker anywhere near it.

Courthouse
A long, dimly lit, north-south corridor stretches away from the courthouse entrance. Closed, unmarked doors line either side of the hall, their pebbled glass windows lit from within by a murky, yellow-orange light. Silence reigns here; your footsteps echo eerily on the tiled floor, and occasionally you can hear muted conversation behind one of the doors -- you can't tell which. At the hall's southern end, a staircase leads down into the basement; a sign hanging above it reads "RECORDS". You can return to Town Square to the north.

Courthouse Basement
A single bulb dangling from the ceiling casts a watery, yellow light against the brick walls. A rickety staircase to the north leads back up to the ground floor, and two narrow doorways lead into the record archives. Over the southeast door hangs a sign that reads "BIRTH RECORDS", while the southwest door bears the sign "DEATH RECORDS".

Birth Records
A bare room with cinderblock walls. Thousands of records and documents, most yellow and brittle with age, are stacked everywhere in towering piles. The exit lies northwest.

>consult records about wilhelm
wilhelm.
wilhelm.
heinrich.
elijah.
mordecai.
edward.
You can't find that name anywhere in the records.

* * *

The oldest and strongest emotion of mankind
is fear, and the oldest and strongest kind of
fear is fear of the unknown.

-- H.P. Lovecraft
                                                                                                                                                                                                                                                  I N F O R M H E A D

Please press SPACE to continue.

>w. s. s. s. s.
Narrow Street
As the lane winds along from east to west, it narrows until the steep, jagged rooftops on either side of the street practically touch each other. To the south, a side street leads across Whateley Bridge toward the center of town, and a twisting lane leads up a hill to the northwest. A short flight of steps to the north leads down to the local watering hole.

Whateley Bridge
A hoary monument of crumbling, moss-eaten flagstones, Whateley Bridge is possibly older than any other structure in the entire city. Ponderously it spans the dark, torpid waters of the Miskaton River, connecting the north and south halves of the city and occasionally raining bits of gravel and mortar from its underside into the water. It looks just wide enough for two cars to pass each other between the flanking stone parapets, but you wouldn't volunteer to try it.

Town Square
A wide expanse of uneven pavestones lies open to the sky, bordered on all sides by the leaning, steep-roofed architecture that looms over everything in this city. The municipal courthouse stands at the south end of the square, next to the mouth of a dark, narrow alley to the southwest. Avenues to the west and east lead back into the cramped and ingrown streets, while to the north lies Whateley Bridge.

In the center of the square, rising from a circular lawn of unhealthy-looking grass and weeds, stands a strange, stone obelisk. It seems to be a monument of some sort, although you can see no plaque or marker anywhere near it.

Courthouse
A long, dimly lit, north-south corridor stretches away from the courthouse entrance. Closed, unmarked doors line either side of the hall, their pebbled glass windows lit from within by a murky, yellow-orange light. Silence reigns here; your footsteps echo eerily on the tiled floor, and occasionally you can hear muted conversation behind one of the doors -- you can't tell which. At the hall's southern end, a staircase leads down into the basement; a sign hanging above it reads "RECORDS". You can return to Town Square to the north.

All of the doors are locked.

>se
All of the doors are locked.

>d
Courthouse Basement
A single bulb dangling from the ceiling casts a watery, yellow light against the brick walls. A rickety staircase to the north leads back up to the ground floor, and two narrow doorways lead into the record archives. Over the southeast door hangs a sign that reads "BIRTH RECORDS", while the southwest door bears the sign "DEATH RECORDS".

* * *

>se
Birth Records
A bare room with cinderblock walls. Thousands of records and documents, most yellow and brittle with age, are stacked everywhere in towering piles. The exit lies northwest.

>consult records about wilhelm
wilhelm matches wilhelm?

*** Run-time problem P29: Attempt to see if a snippet of text matches something which is not a topic.

false.
wilhelm matches heinrich?
false.
wilhelm matches elijah?
false.
wilhelm matches mordecai?
false.
wilhelm matches edward?
false.

* * *

The oldest and strongest emotion of mankind
is fear, and the oldest and strongest kind of
fear is fear of the unknown.

-- H.P. Lovecraft
                                                                                                                                                                                                                                                  I N F O R M H E A D

Please press SPACE to continue.

>w. w. n.
Narrow Street
As the lane winds along from east to west, it narrows until the steep, jagged rooftops on either side of the street practically touch each other. To the south, a side street leads across Whateley Bridge toward the center of town, and a twisting lane leads up a hill to the northwest. A short flight of steps to the north leads down to the local watering hole.

Junction
To the north, a gap in the crowded press of gloomy buildings opens onto a country lane, heading out over a grassy heath. The main street continues to the east, while to the northwest, over the top of a steep rise, you can just make out the vaulted rooftops of the university.

Mill Road
The road carries you across a desolate heath of gray, windswept grass. To the south, the black, jagged outline of Anchorhead's steep roofs and sharp, leaning gables cuts across the horizon. The road forks here to the west and east, heading across the railroad tracks in one direction, out toward the seashore in the other.

>w
As you cross the railroad tracks, the air becomes warmer, more dingy, and slightly more difficult to breathe.

Entrance to the Paper Mill
The road turns southwest here and runs squarely through the front entrance to the old paper mill. A gate of heavy iron bars blocks the only opening into this charred fortress, although an overgrown path leads around the wall to the south. To the north, a rutted lane threads its way past a row of dilapidated shacks.

You can see an iron gate here.

* * *

>sw
The road goes north and east from here. The mill gate lies southwest, and an overgrown trail leads south.

>x gate
The gate, a twenty-foot high barricade of narrowly spaced, thick, black, iron bars, is designed to roll horizontally, sealing off the entrance to the mill compound. It is currently shut and locked.  There are no guardhouses, no buzzers or intercoms, no apparent means of getting in or letting anyone inside know you want in; just this implacable gate in an unscalable wall.

* * *

>w.
As you cross the railroad tracks, the air becomes warmer, more dingy, and slightly more difficult to breathe.

Entrance to the Paper Mill
The road turns southwest here and runs squarely through the front entrance to the old paper mill. A gate of heavy iron bars blocks the only opening into this charred fortress, although an overgrown path leads around the wall to the south. To the north, a rutted lane threads its way past a row of dilapidated shacks.

>sw
The road goes north and east from here. The mill gate lies southwest, and an overgrown trail leads south.

* * *

>x gate
The gate, a twenty-foot high barricade of narrowly spaced, thick, black, iron bars, is designed to roll horizontally, sealing off the entrance to the mill compound. It is currently shut and locked.  There are no guardhouses, no buzzers or intercoms, no apparent means of getting in or letting anyone inside know you want in; just this implacable gate in an unscalable wall.

>x iron bar
I only understood you as far as wanting to examine the iron gate.

>x bars
The gate, a twenty-foot high barricade of narrowly spaced, thick, black, iron bars, is designed to roll horizontally, sealing off the entrance to the mill compound. It is currently shut and locked.  There are no guardhouses, no buzzers or intercoms, no apparent means of getting in or letting anyone inside know you want in; just this implacable gate in an unscalable wall.

>x iron
The gate, a twenty-foot high barricade of narrowly spaced, thick, black, iron bars, is designed to roll horizontally, sealing off the entrance to the mill compound. It is currently shut and locked.  There are no guardhouses, no buzzers or intercoms, no apparent means of getting in or letting anyone inside know you want in; just this implacable gate in an unscalable wall.

>sw
The road goes north and east from here. The mill gate lies southwest, and an overgrown trail leads south.

* * *

The oldest and strongest emotion of mankind
is fear, and the oldest and strongest kind of
fear is fear of the unknown.

-- H.P. Lovecraft
                                                                                                                                                                                                                                                  I N F O R M H E A D

Please press SPACE to continue.

>w. w. n. test hatch.
Narrow Street
As the lane winds along from east to west, it narrows until the steep, jagged rooftops on either side of the street practically touch each other. To the south, a side street leads across Whateley Bridge toward the center of town, and a twisting lane leads up a hill to the northwest. A short flight of steps to the north leads down to the local watering hole.

Junction
To the north, a gap in the crowded press of gloomy buildings opens onto a country lane, heading out over a grassy heath. The main street continues to the east, while to the northwest, over the top of a steep rise, you can just make out the vaulted rooftops of the university.

Mill Road
The road carries you across a desolate heath of gray, windswept grass. To the south, the black, jagged outline of Anchorhead's steep roofs and sharp, leaning gables cuts across the horizon. The road forks here to the west and east, heading across the railroad tracks in one direction, out toward the seashore in the other.

(Testing.)

>[1] w
As you cross the railroad tracks, the air becomes warmer, more dingy, and slightly more difficult to breathe.

Entrance to the Paper Mill
The road turns southwest here and runs squarely through the front entrance to the old paper mill. A gate of heavy iron bars blocks the only opening into this charred fortress, although an overgrown path leads around the wall to the south. To the north, a rutted lane threads its way past a row of dilapidated shacks.

>[2] nw
The road goes north and east from here. The mill gate lies southwest, and an overgrown trail leads south.

>[3] sw
The path curves southwest, leading you into an overgrown area behind the mill.

Bare Foundations
The foundations of an older structure lie crumbling in a sunken square of ground, hidden away behind the imposing shadow of the mill wall. Weeds push up through cracked and buckling slabs of concrete; twisted rebar and rusting pipes poke up like the legs of dead insects. The ruins are surrounded on all sides by dense thickets, although narrow, overgrown trails lead northeast and southeast through the underbrush.

>[4] e
The thickets are too dense in that direction.

>[5] ne
The path curves north, leading you around to the front of the mill.

Entrance to the Paper Mill
The road turns southwest here and runs squarely through the front entrance to the old paper mill. A gate of heavy iron bars blocks the only opening into this charred fortress, although an overgrown path leads around the wall to the south. To the north, a rutted lane threads its way past a row of dilapidated shacks.

* * *

The oldest and strongest emotion of mankind
is fear, and the oldest and strongest kind of
fear is fear of the unknown.

-- H.P. Lovecraft
                                                                                                                                                                                                                                                  I N F O R M H E A D

Please press SPACE to continue.

>w. w. n. w.
Narrow Street
As the lane winds along from east to west, it narrows until the steep, jagged rooftops on either side of the street practically touch each other. To the south, a side street leads across Whateley Bridge toward the center of town, and a twisting lane leads up a hill to the northwest. A short flight of steps to the north leads down to the local watering hole.

Junction
To the north, a gap in the crowded press of gloomy buildings opens onto a country lane, heading out over a grassy heath. The main street continues to the east, while to the northwest, over the top of a steep rise, you can just make out the vaulted rooftops of the university.

Mill Road
The road carries you across a desolate heath of gray, windswept grass. To the south, the black, jagged outline of Anchorhead's steep roofs and sharp, leaning gables cuts across the horizon. The road forks here to the west and east, heading across the railroad tracks in one direction, out toward the seashore in the other.

As you cross the railroad tracks, the air becomes warmer, more dingy, and slightly more difficult to breathe.

Entrance to the Paper Mill
The road turns southwest here and runs squarely through the front entrance to the old paper mill. A gate of heavy iron bars blocks the only opening into this charred fortress, although an overgrown path leads around the wall to the south. To the north, a rutted lane threads its way past a row of dilapidated shacks.

>sw
(first opening the iron gate)
It seems to be locked.

>s
The path curves southwest, leading you into an overgrown area behind the mill.

Bare Foundations
The foundations of an older structure lie crumbling in a sunken square of ground, hidden away behind the imposing shadow of the mill wall. Weeds push up through cracked and buckling slabs of concrete; twisted rebar and rusting pipes poke up like the legs of dead insects. The ruins are surrounded on all sides by dense thickets, although narrow, overgrown trails lead northeast and southeast through the underbrush.

Set into the base of the mill wall, nearly covered by the thickets, is a metal hatch.

>n
The thickets are too dense in that direction.

* * *

The oldest and strongest emotion of mankind
is fear, and the oldest and strongest kind of
fear is fear of the unknown.

-- H.P. Lovecraft
                                                                                                                                                                                                                                                  I N F O R M H E A D

Please press SPACE to continue.

>w. w. n. w. s.
Narrow Street
As the lane winds along from east to west, it narrows until the steep, jagged rooftops on either side of the street practically touch each other. To the south, a side street leads across Whateley Bridge toward the center of town, and a twisting lane leads up a hill to the northwest. A short flight of steps to the north leads down to the local watering hole.

Junction
To the north, a gap in the crowded press of gloomy buildings opens onto a country lane, heading out over a grassy heath. The main street continues to the east, while to the northwest, over the top of a steep rise, you can just make out the vaulted rooftops of the university.

Mill Road
The road carries you across a desolate heath of gray, windswept grass. To the south, the black, jagged outline of Anchorhead's steep roofs and sharp, leaning gables cuts across the horizon. The road forks here to the west and east, heading across the railroad tracks in one direction, out toward the seashore in the other.

As you cross the railroad tracks, the air becomes warmer, more dingy, and slightly more difficult to breathe.

Entrance to the Paper Mill
The road turns southwest here and runs squarely through the front entrance to the old paper mill. A gate of heavy iron bars blocks the only opening into this charred fortress, although an overgrown path leads around the wall to the south. To the north, a rutted lane threads its way past a row of dilapidated shacks.

The path curves southwest, leading you into an overgrown area behind the mill.

Bare Foundations
The foundations of an older structure lie crumbling in a sunken square of ground, hidden away behind the imposing shadow of the mill wall. Weeds push up through cracked and buckling slabs of concrete; twisted rebar and rusting pipes poke up like the legs of dead insects. The ruins are surrounded on all sides by dense thickets, although narrow, overgrown trails lead northeast and southeast through the underbrush.

>search thicket.
Carefully pushing the prickly branches aside, you find a rusty metal hatch set into the base of the wall.

>l
Bare Foundations
The foundations of an older structure lie crumbling in a sunken square of ground, hidden away behind the imposing shadow of the mill wall. Weeds push up through cracked and buckling slabs of concrete; twisted rebar and rusting pipes poke up like the legs of dead insects. The ruins are surrounded on all sides by dense thickets, although narrow, overgrown trails lead northeast and southeast through the underbrush.

Set into the base of the mill wall, nearly covered by the thickets, is a metal hatch.

* * *

The oldest and strongest emotion of mankind
is fear, and the oldest and strongest kind of
fear is fear of the unknown.

-- H.P. Lovecraft
                                                                                                                                                                                                                                                  I N F O R M H E A D

Please press SPACE to continue.

>w. w. n. w. sw.
Narrow Street
As the lane winds along from east to west, it narrows until the steep, jagged rooftops on either side of the street practically touch each other. To the south, a side street leads across Whateley Bridge toward the center of town, and a twisting lane leads up a hill to the northwest. A short flight of steps to the north leads down to the local watering hole.

Junction
To the north, a gap in the crowded press of gloomy buildings opens onto a country lane, heading out over a grassy heath. The main street continues to the east, while to the northwest, over the top of a steep rise, you can just make out the vaulted rooftops of the university.

Mill Road
The road carries you across a desolate heath of gray, windswept grass. To the south, the black, jagged outline of Anchorhead's steep roofs and sharp, leaning gables cuts across the horizon. The road forks here to the west and east, heading across the railroad tracks in one direction, out toward the seashore in the other.

As you cross the railroad tracks, the air becomes warmer, more dingy, and slightly more difficult to breathe.

Entrance to the Paper Mill
The road turns southwest here and runs squarely through the front entrance to the old paper mill. A gate of heavy iron bars blocks the only opening into this charred fortress, although an overgrown path leads around the wall to the south. To the north, a rutted lane threads its way past a row of dilapidated shacks.

(first opening the iron gate)
It seems to be locked.

* * *

>s
The path curves southwest, leading you into an overgrown area behind the mill.

Bare Foundations
The foundations of an older structure lie crumbling in a sunken square of ground, hidden away behind the imposing shadow of the mill wall. Weeds push up through cracked and buckling slabs of concrete; twisted rebar and rusting pipes poke up like the legs of dead insects. The ruins are surrounded on all sides by dense thickets, although narrow, overgrown trails lead northeast and southeast through the underbrush.

>n
hatch

>s
Bare Foundations
The foundations of an older structure lie crumbling in a sunken square of ground, hidden away behind the imposing shadow of the mill wall. Weeds push up through cracked and buckling slabs of concrete; twisted rebar and rusting pipes poke up like the legs of dead insects. The ruins are surrounded on all sides by dense thickets, although narrow, overgrown trails lead northeast and southeast through the underbrush.

* * *

The oldest and strongest emotion of mankind
is fear, and the oldest and strongest kind of
fear is fear of the unknown.

-- H.P. Lovecraft
                                                                                                                                                                                                                                                  I N F O R M H E A D

Please press SPACE to continue.

>w. w. w. nw. w. n.
Narrow Street
As the lane winds along from east to west, it narrows until the steep, jagged rooftops on either side of the street practically touch each other. To the south, a side street leads across Whateley Bridge toward the center of town, and a twisting lane leads up a hill to the northwest. A short flight of steps to the north leads down to the local watering hole.

Junction
To the north, a gap in the crowded press of gloomy buildings opens onto a country lane, heading out over a grassy heath. The main street continues to the east, while to the northwest, over the top of a steep rise, you can just make out the vaulted rooftops of the university.

The street goes east and northwest, or you can take the road out of town to the north.

University Court
Isolated and serene within its high, ivy-covered walls, Miskaton University represents this benighted town's single, if somewhat dubious, claim to cultural achievement. Founded some time in the early 1800s, the school's reputation and enrollment have diminished somewhat as Anchorhead drifts further and further into the abyss of provincial backwaterism. Still, it is generally recognized for its collection of folklore and esoteric mythology (one of the oldest and most extensive on the east coast). The Board of Deans was also kind enough to offer Michael a full professorship upon hearing of his recently discovered heritage and his plans to move into the estate. Ivory tower, perhaps, but at least they take care of their own.

There are numerous buildings surrounding this cobbled court, but the only one you are interested in is the library to the west, where Michael told you he'd be until he came back to the real estate agent's office to pick you up. Which, incidentally, he has not yet done.

University Library
Shadows roost thickly in the vaulted ceiling, and small, green-shaded desk lamps cast pools of warm radiance here and there around the library's dim interior. You pause a moment to let the hushed peacefulness of this place soak in -- a welcome relief from the unsettling events of the day. An exit lies east, and a small alcove to the north houses the circulation counter.

Peering through the shadows, you spot your husband sitting at one of the reading desks, absorbed in some sort of weighty tome and clearly oblivious to the time.

Michael turns to a new page in the book and begins reading intently.

Circulation Desk
A high counter divides the public portion of the library from the reserved stacks -- all the more esoteric and mysterious volumes from the university's collection. If anything, the area behind the counter is even more shadowy than the side you're on. The main reading area lies south.

Hanging on the wall next to the counter is a small, printed sign. Beneath the sign sits a heavy, dog-eared register, and sitting next to the register is a bell.

>read register
It's basically a log, recording what book was checked out, who checked it out, and when. There must be hundreds of names here.

>search register
You find nothing of interest.

>examine register
It's basically a log, recording what book was checked out, who checked it out, and when. There must be hundreds of names here.

* * *

The oldest and strongest emotion of mankind
is fear, and the oldest and strongest kind of
fear is fear of the unknown.

-- H.P. Lovecraft
                                                                                                                                                                                                                                                  I N F O R M H E A D

Please press SPACE to continue.

>w.w.n.
Narrow Street
As the lane winds along from east to west, it narrows until the steep, jagged rooftops on either side of the street practically touch each other. To the south, a side street leads across Whateley Bridge toward the center of town, and a twisting lane leads up a hill to the northwest. A short flight of steps to the north leads down to the local watering hole.

Junction
To the north, a gap in the crowded press of gloomy buildings opens onto a country lane, heading out over a grassy heath. The main street continues to the east, while to the northwest, over the top of a steep rise, you can just make out the vaulted rooftops of the university.

Mill Road
The road carries you across a desolate heath of gray, windswept grass. To the south, the black, jagged outline of Anchorhead's steep roofs and sharp, leaning gables cuts across the horizon. The road forks here to the west and east, heading across the railroad tracks in one direction, out toward the seashore in the other.

>test spur.
(Testing.)

>[1] e

Breakwater
You are picking your way across the breakwater's bare, rocky spine, where the road has diminished to little more than a pair of dusty ruts. A hundred yards to the northeast, at the breakwater's far end, the lonely stone tower of Anchorhead's lighthouse stands vigil against the ocean.

>[2] ne

At the Foot of the Lighthouse
You stand in a circular clearing among the stones, surrounded on nearly every side by the sea. Before you looms the ancient, massive lighthouse, a vertiginous pillar of pale brick jabbing defiantly up at the sky. The road from the southwest ends here, although it looks as though you could pick your way down the rocks to the southeast, around the structure's base.

You can see a bronze door here.

>[3] se
Carefully, you climb down the rocks. The path bends northeast, following the curve of the lighthouse wall.

Rocky Spur
A small outcropping of stone, just large enough for you to stand on, sticks out from the end of the breakwater. The hungry sea laps at your feet, surging over the rocks and then trickling down into crevices. To the southwest, an uneven trail leads back up the rocks, around the side of the lighthouse.

>[4] nw
In that direction there is only the sea.

>[5] u
The trail turns northwest, following the curve of the lighthouse wall.

At the Foot of the Lighthouse
You stand in a circular clearing among the stones, surrounded on nearly every side by the sea. Before you looms the ancient, massive lighthouse, a vertiginous pillar of pale brick jabbing defiantly up at the sky. The road from the southwest ends here, although it looks as though you could pick your way down the rocks to the southeast, around the structure's base.

You can see a bronze door here.

>[6] d
Carefully, you climb down the rocks. The path bends northeast, following the curve of the lighthouse wall.

Rocky Spur
A small outcropping of stone, just large enough for you to stand on, sticks out from the end of the breakwater. The hungry sea laps at your feet, surging over the rocks and then trickling down into crevices. To the southwest, an uneven trail leads back up the rocks, around the side of the lighthouse.

>sw.w.
The trail turns northwest, following the curve of the lighthouse wall.

At the Foot of the Lighthouse
You stand in a circular clearing among the stones, surrounded on nearly every side by the sea. Before you looms the ancient, massive lighthouse, a vertiginous pillar of pale brick jabbing defiantly up at the sky. The road from the southwest ends here, although it looks as though you could pick your way down the rocks to the southeast, around the structure's base.

You can see a bronze door here.

In that direction there is only the sea.

>sw.w.
Breakwater
You are picking your way across the breakwater's bare, rocky spine, where the road has diminished to little more than a pair of dusty ruts. A hundred yards to the northeast, at the breakwater's far end, the lonely stone tower of Anchorhead's lighthouse stands vigil against the ocean.

Mill Road
The road carries you across a desolate heath of gray, windswept grass. To the south, the black, jagged outline of Anchorhead's steep roofs and sharp, leaning gables cuts across the horizon. The road forks here to the west and east, heading across the railroad tracks in one direction, out toward the seashore in the other.

>test hatch
(Testing.)

>[1] w
As you cross the railroad tracks, the air becomes warmer, more dingy, and slightly more difficult to breathe.

Entrance to the Paper Mill
The road turns southwest here and runs squarely through the front entrance to the old paper mill. A gate of heavy iron bars blocks the only opening into this charred fortress, although an overgrown path leads around the wall to the south. To the north, a rutted lane threads its way past a row of dilapidated shacks.

>[2] nw
The road goes north and east from here. The mill gate lies southwest, and an overgrown trail leads south.

>[3] sw
The path curves southwest, leading you into an overgrown area behind the mill.

Bare Foundations
The foundations of an older structure lie crumbling in a sunken square of ground, hidden away behind the imposing shadow of the mill wall. Weeds push up through cracked and buckling slabs of concrete; twisted rebar and rusting pipes poke up like the legs of dead insects. The ruins are surrounded on all sides by dense thickets, although narrow, overgrown trails lead northeast and southeast through the underbrush.

>[4] e
You can't go that way.

>[5] s
You can't go that way.

* * *

>test sput
>--> The following tests are available:
'test mreads'
'test mfollows'
'test msleeps'
'test day1'
'test cans'
'test window'
'test fence'
'test machine'
'test cabinet'
'test cup'
'test door'
'test streets'
'test lantern'
'test flask'
'test pubdeets'
'test library'
'test register'
'test bell'
'test fetchem'
'test mattress'
'test tin'
'test nastymist'
'test goodmist'
'test notice'
'test hatch'
'test spur'

>test spur
(Testing.)

>[1] e

Breakwater
You are picking your way across the breakwater's bare, rocky spine, where the road has diminished to little more than a pair of dusty ruts. A hundred yards to the northeast, at the breakwater's far end, the lonely stone tower of Anchorhead's lighthouse stands vigil against the ocean.

>[2] ne

At the Foot of the Lighthouse
You stand in a circular clearing among the stones, surrounded on nearly every side by the sea. Before you looms the ancient, massive lighthouse, a vertiginous pillar of pale brick jabbing defiantly up at the sky. The road from the southwest ends here, although it looks as though you could pick your way down the rocks to the southeast, around the structure's base.

You can see a bronze door here.

>[3] se
Carefully, you climb down the rocks. The path bends northeast, following the curve of the lighthouse wall.

Rocky Spur
A small outcropping of stone, just large enough for you to stand on, sticks out from the end of the breakwater. The hungry sea laps at your feet, surging over the rocks and then trickling down into crevices. To the southwest, an uneven trail leads back up the rocks, around the side of the lighthouse.

>[4] nw
In that direction there is only the sea.

>[5] u
The trail turns northwest, following the curve of the lighthouse wall.

At the Foot of the Lighthouse
You stand in a circular clearing among the stones, surrounded on nearly every side by the sea. Before you looms the ancient, massive lighthouse, a vertiginous pillar of pale brick jabbing defiantly up at the sky. The road from the southwest ends here, although it looks as though you could pick your way down the rocks to the southeast, around the structure's base.

You can see a bronze door here.

>[6] d
Carefully, you climb down the rocks. The path bends northeast, following the curve of the lighthouse wall.

Rocky Spur
A small outcropping of stone, just large enough for you to stand on, sticks out from the end of the breakwater. The hungry sea laps at your feet, surging over the rocks and then trickling down into crevices. To the southwest, an uneven trail leads back up the rocks, around the side of the lighthouse.

>nw
In that direction there is only the sea.

>sw
The trail turns northwest, following the curve of the lighthouse wall.

At the Foot of the Lighthouse
You stand in a circular clearing among the stones, surrounded on nearly every side by the sea. Before you looms the ancient, massive lighthouse, a vertiginous pillar of pale brick jabbing defiantly up at the sky. The road from the southwest ends here, although it looks as though you could pick your way down the rocks to the southeast, around the structure's base.

You can see a bronze door here.

>sw
Breakwater
You are picking your way across the breakwater's bare, rocky spine, where the road has diminished to little more than a pair of dusty ruts. A hundred yards to the northeast, at the breakwater's far end, the lonely stone tower of Anchorhead's lighthouse stands vigil against the ocean.

>w
Mill Road
The road carries you across a desolate heath of gray, windswept grass. To the south, the black, jagged outline of Anchorhead's steep roofs and sharp, leaning gables cuts across the horizon. The road forks here to the west and east, heading across the railroad tracks in one direction, out toward the seashore in the other.

>test hatch
(Testing.)

>[1] w
As you cross the railroad tracks, the air becomes warmer, more dingy, and slightly more difficult to breathe.

Entrance to the Paper Mill
The road turns southwest here and runs squarely through the front entrance to the old paper mill. A gate of heavy iron bars blocks the only opening into this charred fortress, although an overgrown path leads around the wall to the south. To the north, a rutted lane threads its way past a row of dilapidated shacks.

>[2] nw
The road goes north and east from here. The mill gate lies southwest, and an overgrown trail leads south.

>[3] sw
The path curves southwest, leading you into an overgrown area behind the mill.

Bare Foundations
The foundations of an older structure lie crumbling in a sunken square of ground, hidden away behind the imposing shadow of the mill wall. Weeds push up through cracked and buckling slabs of concrete; twisted rebar and rusting pipes poke up like the legs of dead insects. The ruins are surrounded on all sides by dense thickets, although narrow, overgrown trails lead northeast and southeast through the underbrush.

>[4] e
You can't go that way.

>[5] s
You can't go that way.

* * *

The oldest and strongest emotion of mankind
is fear, and the oldest and strongest kind of
fear is fear of the unknown.

-- H.P. Lovecraft
                                                                                                                                                                                                                                                  I N F O R M H E A D

Please press SPACE to continue.

>w.w.n.test hatch.
Narrow Street
As the lane winds along from east to west, it narrows until the steep, jagged rooftops on either side of the street practically touch each other. To the south, a side street leads across Whateley Bridge toward the center of town, and a twisting lane leads up a hill to the northwest. A short flight of steps to the north leads down to the local watering hole.

Junction
To the north, a gap in the crowded press of gloomy buildings opens onto a country lane, heading out over a grassy heath. The main street continues to the east, while to the northwest, over the top of a steep rise, you can just make out the vaulted rooftops of the university.

Mill Road
The road carries you across a desolate heath of gray, windswept grass. To the south, the black, jagged outline of Anchorhead's steep roofs and sharp, leaning gables cuts across the horizon. The road forks here to the west and east, heading across the railroad tracks in one direction, out toward the seashore in the other.

(Testing.)

>[1] w
As you cross the railroad tracks, the air becomes warmer, more dingy, and slightly more difficult to breathe.

Entrance to the Paper Mill
The road turns southwest here and runs squarely through the front entrance to the old paper mill. A gate of heavy iron bars blocks the only opening into this charred fortress, although an overgrown path leads around the wall to the south. To the north, a rutted lane threads its way past a row of dilapidated shacks.

>[2] nw
The road goes north and east from here. The mill gate lies southwest, and an overgrown trail leads south.

>[3] sw
The path curves southwest, leading you into an overgrown area behind the mill.

Bare Foundations
The foundations of an older structure lie crumbling in a sunken square of ground, hidden away behind the imposing shadow of the mill wall. Weeds push up through cracked and buckling slabs of concrete; twisted rebar and rusting pipes poke up like the legs of dead insects. The ruins are surrounded on all sides by dense thickets, although narrow, overgrown trails lead northeast and southeast through the underbrush.

>[4] e
The thickets are too dense in that direction.

>[5] s
The thickets are too dense in that direction.

>ne
The path curves north, leading you around to the front of the mill.

Entrance to the Paper Mill
The road turns southwest here and runs squarely through the front entrance to the old paper mill. A gate of heavy iron bars blocks the only opening into this charred fortress, although an overgrown path leads around the wall to the south. To the north, a rutted lane threads its way past a row of dilapidated shacks.

* * *

The oldest and strongest emotion of mankind
is fear, and the oldest and strongest kind of
fear is fear of the unknown.

-- H.P. Lovecraft
                                                                                                                                                                                                                                                  I N F O R M H E A D

Please press SPACE to continue.

>w.w.n.w.
Narrow Street
As the lane winds along from east to west, it narrows until the steep, jagged rooftops on either side of the street practically touch each other. To the south, a side street leads across Whateley Bridge toward the center of town, and a twisting lane leads up a hill to the northwest. A short flight of steps to the north leads down to the local watering hole.

Junction
To the north, a gap in the crowded press of gloomy buildings opens onto a country lane, heading out over a grassy heath. The main street continues to the east, while to the northwest, over the top of a steep rise, you can just make out the vaulted rooftops of the university.

Mill Road
The road carries you across a desolate heath of gray, windswept grass. To the south, the black, jagged outline of Anchorhead's steep roofs and sharp, leaning gables cuts across the horizon. The road forks here to the west and east, heading across the railroad tracks in one direction, out toward the seashore in the other.

As you cross the railroad tracks, the air becomes warmer, more dingy, and slightly more difficult to breathe.

Entrance to the Paper Mill
The road turns southwest here and runs squarely through the front entrance to the old paper mill. A gate of heavy iron bars blocks the only opening into this charred fortress, although an overgrown path leads around the wall to the south. To the north, a rutted lane threads its way past a row of dilapidated shacks.

>sw
(first opening the iron gate)
It seems to be locked.

>s
The path curves southwest, leading you into an overgrown area behind the mill.

Bare Foundations
The foundations of an older structure lie crumbling in a sunken square of ground, hidden away behind the imposing shadow of the mill wall. Weeds push up through cracked and buckling slabs of concrete; twisted rebar and rusting pipes poke up like the legs of dead insects. The ruins are surrounded on all sides by dense thickets, although narrow, overgrown trails lead northeast and southeast through the underbrush.

>l
Bare Foundations
The foundations of an older structure lie crumbling in a sunken square of ground, hidden away behind the imposing shadow of the mill wall. Weeds push up through cracked and buckling slabs of concrete; twisted rebar and rusting pipes poke up like the legs of dead insects. The ruins are surrounded on all sides by dense thickets, although narrow, overgrown trails lead northeast and southeast through the underbrush.

>n
The thickets are too dense in that direction.

>search thicket
Carefully pushing the prickly branches aside, you find a rusty metal hatch set into the base of the wall.

>l
Bare Foundations
The foundations of an older structure lie crumbling in a sunken square of ground, hidden away behind the imposing shadow of the mill wall. Weeds push up through cracked and buckling slabs of concrete; twisted rebar and rusting pipes poke up like the legs of dead insects. The ruins are surrounded on all sides by dense thickets, although narrow, overgrown trails lead northeast and southeast through the underbrush.

Set into the base of the mill wall, nearly covered by the thickets, is a metal hatch.

* * *

>n
The thickets are too dense in that direction.

>showme
Bare Foundations - room
    yourself - person
        clothes (worn)
        trenchcoat (worn)
        wedding ring (worn)
        keyring
    hatch - locked door
    thicket

>help
That's not a verb I recognise.

>showme bare foundations
Bare Foundations - room
    yourself - person
        clothes (worn)
        trenchcoat (worn)
        wedding ring (worn)
        keyring
    hatch - locked door
    thicket
lighted, visited; singular-named, proper-named
description: "The foundations of an older structure lie crumbling in a sunken square of ground, hidden away behind the imposing shadow of the mill wall. Weeds push up through cracked and buckling slabs of concrete; twisted rebar and rusting pipes poke up like the legs of dead insects. The ruins are surrounded on all sides by dense thickets, although narrow, overgrown trails lead northeast and southeast through the underbrush."
printed name: "Bare Foundations"
printed plural name: none
indefinite article: none
list grouping key: none

* * *

>s
The path curves southwest, leading you into an overgrown area behind the mill.

Bare Foundations
The foundations of an older structure lie crumbling in a sunken square of ground, hidden away behind the imposing shadow of the mill wall. Weeds push up through cracked and buckling slabs of concrete; twisted rebar and rusting pipes poke up like the legs of dead insects. The ruins are surrounded on all sides by dense thickets, although narrow, overgrown trails lead northeast and southeast through the underbrush.

>n
The thickets are too dense in that direction.

>x thicket
The thickets are full of painful thorns and appear quite impenetrable. They are also very deep; there's no telling what could be hidden -- or what could be hiding -- in their brambly depths.

>search thickets
You can't see any such thing.

>search thicket
Carefully pushing the prickly branches aside, you find a rusty metal hatch set into the base of the wall.

>l
Bare Foundations
The foundations of an older structure lie crumbling in a sunken square of ground, hidden away behind the imposing shadow of the mill wall. Weeds push up through cracked and buckling slabs of concrete; twisted rebar and rusting pipes poke up like the legs of dead insects. The ruins are surrounded on all sides by dense thickets, although narrow, overgrown trails lead northeast and southeast through the underbrush.

* * *

>n
The thickets are too dense in that direction.

>showme
Bare Foundations - room
    yourself - person
        clothes (worn)
        trenchcoat (worn)
        wedding ring (worn)
        keyring
    thicket

* * *

The oldest and strongest emotion of mankind
is fear, and the oldest and strongest kind of
fear is fear of the unknown.

-- H.P. Lovecraft
                                                                                                                                                                                                                                                  I N F O R M H E A D

Please press SPACE to continue.

>w.w.n.w.s.sw.
Narrow Street
As the lane winds along from east to west, it narrows until the steep, jagged rooftops on either side of the street practically touch each other. To the south, a side street leads across Whateley Bridge toward the center of town, and a twisting lane leads up a hill to the northwest. A short flight of steps to the north leads down to the local watering hole.

Junction
To the north, a gap in the crowded press of gloomy buildings opens onto a country lane, heading out over a grassy heath. The main street continues to the east, while to the northwest, over the top of a steep rise, you can just make out the vaulted rooftops of the university.

Mill Road
The road carries you across a desolate heath of gray, windswept grass. To the south, the black, jagged outline of Anchorhead's steep roofs and sharp, leaning gables cuts across the horizon. The road forks here to the west and east, heading across the railroad tracks in one direction, out toward the seashore in the other.

As you cross the railroad tracks, the air becomes warmer, more dingy, and slightly more difficult to breathe.

Entrance to the Paper Mill
The road turns southwest here and runs squarely through the front entrance to the old paper mill. A gate of heavy iron bars blocks the only opening into this charred fortress, although an overgrown path leads around the wall to the south. To the north, a rutted lane threads its way past a row of dilapidated shacks.

The path curves southwest, leading you into an overgrown area behind the mill.

Bare Foundations
The foundations of an older structure lie crumbling in a sunken square of ground, hidden away behind the imposing shadow of the mill wall. Weeds push up through cracked and buckling slabs of concrete; twisted rebar and rusting pipes poke up like the legs of dead insects. The ruins are surrounded on all sides by dense thickets, although narrow, overgrown trails lead northeast and southeast through the underbrush.

Set into the base of the mill wall, nearly covered by the thickets, is a metal hatch.

The thickets are too dense in that direction.

* * *

The oldest and strongest emotion of mankind
is fear, and the oldest and strongest kind of
fear is fear of the unknown.

-- H.P. Lovecraft
                                                                                                                                                                                                                                                  I N F O R M H E A D

Please press SPACE to continue.

>w.w.n.w.sw.search thicket.
Narrow Street
As the lane winds along from east to west, it narrows until the steep, jagged rooftops on either side of the street practically touch each other. To the south, a side street leads across Whateley Bridge toward the center of town, and a twisting lane leads up a hill to the northwest. A short flight of steps to the north leads down to the local watering hole.

Junction
To the north, a gap in the crowded press of gloomy buildings opens onto a country lane, heading out over a grassy heath. The main street continues to the east, while to the northwest, over the top of a steep rise, you can just make out the vaulted rooftops of the university.

Mill Road
The road carries you across a desolate heath of gray, windswept grass. To the south, the black, jagged outline of Anchorhead's steep roofs and sharp, leaning gables cuts across the horizon. The road forks here to the west and east, heading across the railroad tracks in one direction, out toward the seashore in the other.

As you cross the railroad tracks, the air becomes warmer, more dingy, and slightly more difficult to breathe.

Entrance to the Paper Mill
The road turns southwest here and runs squarely through the front entrance to the old paper mill. A gate of heavy iron bars blocks the only opening into this charred fortress, although an overgrown path leads around the wall to the south. To the north, a rutted lane threads its way past a row of dilapidated shacks.

(first opening the iron gate)
It seems to be locked.

You can't see any such thing.

>s
The path curves southwest, leading you into an overgrown area behind the mill.

Bare Foundations
The foundations of an older structure lie crumbling in a sunken square of ground, hidden away behind the imposing shadow of the mill wall. Weeds push up through cracked and buckling slabs of concrete; twisted rebar and rusting pipes poke up like the legs of dead insects. The ruins are surrounded on all sides by dense thickets, although narrow, overgrown trails lead northeast and southeast through the underbrush.

>search thicket.
Carefully pushing the prickly branches aside, you find a rusty metal hatch set into the base of the wall.

>l
Bare Foundations
The foundations of an older structure lie crumbling in a sunken square of ground, hidden away behind the imposing shadow of the mill wall. Weeds push up through cracked and buckling slabs of concrete; twisted rebar and rusting pipes poke up like the legs of dead insects. The ruins are surrounded on all sides by dense thickets, although narrow, overgrown trails lead northeast and southeast through the underbrush.

* * *

The oldest and strongest emotion of mankind
is fear, and the oldest and strongest kind of
fear is fear of the unknown.

-- H.P. Lovecraft
                                                                                                                                                                                                                                                  I N F O R M H E A D

Please press SPACE to continue.

>w.w.n.w.w
Narrow Street
As the lane winds along from east to west, it narrows until the steep, jagged rooftops on either side of the street practically touch each other. To the south, a side street leads across Whateley Bridge toward the center of town, and a twisting lane leads up a hill to the northwest. A short flight of steps to the north leads down to the local watering hole.

Junction
To the north, a gap in the crowded press of gloomy buildings opens onto a country lane, heading out over a grassy heath. The main street continues to the east, while to the northwest, over the top of a steep rise, you can just make out the vaulted rooftops of the university.

Mill Road
The road carries you across a desolate heath of gray, windswept grass. To the south, the black, jagged outline of Anchorhead's steep roofs and sharp, leaning gables cuts across the horizon. The road forks here to the west and east, heading across the railroad tracks in one direction, out toward the seashore in the other.

As you cross the railroad tracks, the air becomes warmer, more dingy, and slightly more difficult to breathe.

Entrance to the Paper Mill
The road turns southwest here and runs squarely through the front entrance to the old paper mill. A gate of heavy iron bars blocks the only opening into this charred fortress, although an overgrown path leads around the wall to the south. To the north, a rutted lane threads its way past a row of dilapidated shacks.

You can't go that way.

>sw
(first opening the iron gate)
It seems to be locked.

* * *

>n
The thickets are too dense in that direction.

>x thickets
You can't see any such thing.

>x thicket
The thickets are full of painful thorns and appear quite impenetrable. They are also very deep; there's no telling what could be hidden -- or what could be hiding -- in their brambly depths.

>search thicket
Carefully pushing the prickly branches aside, you find a rusty metal hatch set into the base of the wall.

* * *

>l
Bare Foundations
The foundations of an older structure lie crumbling in a sunken square of ground, hidden away behind the imposing shadow of the mill wall. Weeds push up through cracked and buckling slabs of concrete; twisted rebar and rusting pipes poke up like the legs of dead insects. The ruins are surrounded on all sides by dense thickets, although narrow, overgrown trails lead northeast and southeast through the underbrush.

>showme
Bare Foundations - room
    yourself - person
        clothes (worn)
        trenchcoat (worn)
        wedding ring (worn)
        keyring
    hatch - locked door
    thicket

>x hatch
Set into the base of the mill wall, nearly covered by the thickets, is a metal hatch.

>showme hatch
hatch - locked door
location: in Bare Foundations
unlit, inedible, fixed in place, scenery; closed, openable, lockable, locked; singular-named, improper-named
description: "Set into the base of the mill wall, nearly covered by the thickets, is a metal hatch."
initial appearance: none
printed name: "hatch"
printed plural name: "doors"
indefinite article: none
list grouping key: none

* * *

The oldest and strongest emotion of mankind
is fear, and the oldest and strongest kind of
fear is fear of the unknown.

-- H.P. Lovecraft
                                                                                                                                                                                                                                                  I N F O R M H E A D

Please press SPACE to continue.

>x door
The door has a glass front with the name of the real estate company -- Benson & Brackhurst -- stenciled across it. The blinds are drawn, the lights are off inside, and no one appears to be home. Odd, since the agent knew you were coming today.

>e
(first opening the office door)
It seems to be locked.

>se
Alley
This narrow aperture between two buildings is nearly blocked with piles of rotting cardboard boxes and overstuffed garbage cans. Ugly, half-crumbling brick walls to either side totter oppressively over you. The alley ends here at a tall, wooden fence.

High up on the wall of the northern building there is a narrow, transom-style window.

* * *

>x door
You can't see any such thing.

>x office door
You can't see any such thing.

* * *

The oldest and strongest emotion of mankind
is fear, and the oldest and strongest kind of
fear is fear of the unknown.

-- H.P. Lovecraft
                                                                                                                                                                                                                                                  I N F O R M H E A D

Please press SPACE to continue.

>x keyring
An old tchochke from a forgotten holiday.

>x wedding ring
Staring at your wedding ring like that tends to make you sentimental.

>i
You are carrying:
  your wedding ring (being worn)
  a keyring

* * *

The oldest and strongest emotion of mankind
is fear, and the oldest and strongest kind of
fear is fear of the unknown.

-- H.P. Lovecraft
                                                                                                                                                                                                                                                  I N F O R M H E A D

Please press SPACE to continue.

>x latch
It's a little knob that can be turned to lock or unlock the door. It's currently locked.

* * *

The oldest and strongest emotion of mankind
is fear, and the oldest and strongest kind of
fear is fear of the unknown.

-- H.P. Lovecraft
                                                                                                                                                                                                                                                  I N F O R M H E A D

Please press SPACE to continue.

>x notice
It's a letter from the Arkham Regional Utilities Company, explaining that, due to wiring difficulties, the electricity will not be installed until next week. No phone service, either.

>x notice
It's a letter from the Arkham Regional Utilities Company, explaining that, due to wiring difficulties, the electricity will not be installed until next week. No phone service, either.

>showme notice
a typewritten notice - thing
location: in Outside the Real Estate Office
unlit, inedible, portable; singular-named, improper-named; read
description: "It's a letter from the Arkham Regional Utilities Company, explaining that, due to wiring difficulties, the electricity will not be installed until next week. No phone service, either."
initial appearance: none
printed name: "a typewritten notice"
printed plural name: none
indefinite article: none
list grouping key: none

* * *

The oldest and strongest emotion of mankind
is fear, and the oldest and strongest kind of
fear is fear of the unknown.

-- H.P. Lovecraft
                                                                                                                                                                                                                                                  I N F O R M H E A D

Please press SPACE to continue.

>x pants
They're the same plain khakis he usually wears. You notice something in the back pocket.

>1ook in pants
That's not a verb I recognise.

>look in pants
In Michael's pants is Michael's wallet.

>take pants
Taken.

>i
You are carrying:
  Michael's pants
    Michael's wallet
      Michael's faculty card
  your clothes (being worn)
  your trenchcoat (being worn)
  your wedding ring (being worn)
  a keyring

* * *

>x pants
They're the same plain khakis he usually wears. You notice something in the back pocket.

>look in pants
In Michael's pants is Michael's wallet.

>search pants
In Michael's pants is Michael's wallet.

>take wallet
Taken.

>l
Outside the Real Estate Office
A grim little cul-de-sac, tucked away in a corner of the claustrophobic tangle of narrow, twisting avenues that largely constitute the older portion of Anchorhead. Like most of the streets in this city, it is ancient, shadowy, and leads essentially nowhere. The lane ends here at the real estate agent's office, which lies to the east, and winds its way back toward the center of town to the west. A narrow, garbage-choked alley opens to the southeast.

On the four-poster bed you can see Michael's pants.

>x pants
They're the same plain khakis he usually wears.

* * *

>look in wallet
In Michael's wallet is Michael's faculty card.

>take card
Taken.

>i
You are carrying:
  Michael's faculty card
  your clothes (being worn)
  your trenchcoat (being worn)
  your wedding ring (being worn)
  a keyring

>x card
The card identifies your husband as a faculty member at Miskaton University, entitled to all the privileges that implies.

>l
Outside the Real Estate Office
A grim little cul-de-sac, tucked away in a corner of the claustrophobic tangle of narrow, twisting avenues that largely constitute the older portion of Anchorhead. Like most of the streets in this city, it is ancient, shadowy, and leads essentially nowhere. The lane ends here at the real estate agent's office, which lies to the east, and winds its way back toward the center of town to the west. A narrow, garbage-choked alley opens to the southeast.

On the four-poster bed you can see Michael's pants.

* * *

>x pants
They're the same plain khakis he usually wears. You notice something in the back pocket.

>open pants
It isn't something you can open.

>take pants
Taken.

>i
You are carrying:
  Michael's pants
  your clothes (being worn)
  your trenchcoat (being worn)
  your wedding ring (being worn)
  a keyring

>look in pants
Michael's pants is empty.

* * *

>x pants
They're the same plain khakis he usually wears. You notice something in the back pocket.

>search pants
In Michael's pants is Michael's wallet.

>l
Outside the Real Estate Office
A grim little cul-de-sac, tucked away in a corner of the claustrophobic tangle of narrow, twisting avenues that largely constitute the older portion of Anchorhead. Like most of the streets in this city, it is ancient, shadowy, and leads essentially nowhere. The lane ends here at the real estate agent's office, which lies to the east, and winds its way back toward the center of town to the west. A narrow, garbage-choked alley opens to the southeast.

On the four-poster bed you can see Michael's pants.

>x pants
They're the same plain khakis he usually wears. You notice something in the back pocket.

>showme
Outside the Real Estate Office - room
    office door - locked door
        latch (part of office door)
    sky - backdrop
    cobblestones - backdrop
    rooftops - backdrop
    yourself - person
        clothes (worn)
        trenchcoat (worn)
        wedding ring (worn)
        keyring
    Michael's pants - open container
        Michael's wallet - closed container

>showme wallet
Michael's wallet - closed container
location: in Michael's pants in Outside the Real Estate Office
unlit, inedible, portable; opaque, closed, openable, unlocked; singular-named, proper-named
description: "It's just his wallet, an ordinary leather wallet."
initial appearance: none
carrying capacity: 100
printed name: "Michael's wallet"
printed plural name: "containers"
indefinite article: none
list grouping key: none

* * *

>search pants
In Michael's pants is Michael's wallet.

>x wallet
It's just his wallet, an ordinary leather wallet.

In Michael's wallet is Michael's faculty card.

>look in wallet
You can't see inside, since Michael's wallet is closed.

* * *

>take pants
Taken.

>look in pants
Michael's pants are empty.

>search pants
Michael's pants are empty.

>examine pants
They're the same plain khakis he usually wears. You notice something in the back pocket.

* * *

The oldest and strongest emotion of mankind
is fear, and the oldest and strongest kind of
fear is fear of the unknown.

-- H.P. Lovecraft
                                                                                                                                                                                                                                                  I N F O R M H E A D

Please press SPACE to continue.

>x pantsa
You can't see any such thing.

>x pants
They're the same plain khakis he usually wears.
 You notice something in the back pocket.

* * *

The oldest and strongest emotion of mankind
is fear, and the oldest and strongest kind of
fear is fear of the unknown.

-- H.P. Lovecraft
                                                                                                                                                                                                                                                  I N F O R M H E A D

Please press SPACE to continue.

>x ring
Staring at your wedding ring like that tends to make you sentimental.

>remove it
You take off the wedding ring.

>x it
Engraved along the inside are Michael's and your initials, along with your wedding date -- June 28th..

>wear it
You put on the wedding ring.

>x it
Staring at your wedding ring like that tends to make you sentimental.

* * *

The oldest and strongest emotion of mankind
is fear, and the oldest and strongest kind of
fear is fear of the unknown.

-- H.P. Lovecraft
                                                                                                                                                                                                                                                  I N F O R M H E A D

Please press SPACE to continue.

>x volume
It's an old medieval tome dated in the early 1300s, written by one Galarian Academius desChamps.

* * *

>read it
It's an old medieval tome dated in the early 1300s, written by one Galarian Academius desChamps.

>read trenchcoat
You bought this coat during your honeymoon in England; it's a genuine London Fog. In addition to looking very cool, it has several deep pockets in which you can fit just about anything.

>x chair
You can't see any such thing.

* * *

>read trenchcoat
You bought this coat during your honeymoon in England; it's a genuine London Fog. In addition to looking very cool, it has several deep pockets in which you can fit just about anything.

>examine coat
You can't see any such thing.

>x trenchcoat
You bought this coat during your honeymoon in England; it's a genuine London Fog. In addition to looking very cool, it has several deep pockets in which you can fit just about anything.

I beg your pardon?

* * *

>read it
It's an old medieval tome dated in the early 1300s, written by one Galarian Academius desChamps.

>take it
Taken.

>read it
It's an old medieval tome dated in the early 1300s, written by one Galarian Academius desChamps.

>search manual
You find nothing of interest.

>i
You are carrying:
  a The Compleat Manual of Wardes and Seales
  your clothes (being worn)
  your trenchcoat (being worn)
  your wedding ring (being worn)
  a keyring

>search clothes
You find nothing of interest.

* * *

The oldest and strongest emotion of mankind
is fear, and the oldest and strongest kind of
fear is fear of the unknown.

-- H.P. Lovecraft
                                                                                                                                                                                                                                                  I N F O R M H E A D

Please press SPACE to continue.

>z
Time passes.

The rain slackens off momentarily to a weak drizzle, then returns afresh in a brief, freezing downpour.

>z
Time passes.

>z
Time passes.

In the distance, you can hear the lonesome keening of a train whistle drifting on the wind.

>z
Time passes.

>z
Time passes.

The rain slackens off momentarily to a weak drizzle, then returns afresh in a brief, freezing downpour.

>z
Time passes.

The clouds overhead mutter restlessly to themselves.

>z
Time passes.

The rain slackens off momentarily to a weak drizzle, then returns afresh in a brief, freezing downpour.